Name	Title	Coding	Subreddit
t3_jzlvmf	Walmart Thanks Government For Completely Obliterating Their Small Business Competition	Other	Conservative
t3_jzg2l7	Holocaust Museum In Florida Sparks Outrage After Adding George Floyd Exhibit	Other	Conservative
t3_jzisoe	After Trans Activists Try To Ban The Book ‘Irreversible Damage,’ It Becomes A Bestseller -- Trans activists keep bullying businesses into removing content through fear tactics rather than by countering the message with their own better one.	Other	Conservative
t3_jzm37a	This would literally kill me	Other	Conservative
t3_jzigda	Gavin Newsom Alerted To Illegal Activity By The Sound Of Children’s Laughter	Other	Conservative
t3_jzgsw6	Nearly 40 Shot Friday into Sunday Morning in Lightfoot's Chicago	Other	Conservative
t3_jzr6s5	Michigan's State Board of Canvassers votes to certify election	Other	Conservative
t3_jzl0m1	Harvard creating new ‘antiracism’ librarian job. It pays up to $240,300 per year.	Other	Conservative
t3_jzdeil	Beijing-Controlled News Outlet Paid US Newspapers Millions To Publish Propaganda This Year	Other	Conservative
t3_jzi3j1	‘It Will Be Epic’: Sidney Powell Releases Another Statement After Lawyers Say She’s Not On Team	Other	Conservative
t3_jzetu8	Calls for Britain to give asylum to Pakistani Christian girl forced to marry Muslim man who abducted and gang-raped her	Other	Conservative
t3_jznn1y	White Anti-Racism Author Robin DiAngelo Paid More Than Black Woman To Speak At Same Diversity Forum	Other	Conservative
t3_jzc6ln	Protesters take to the streets in California to bash Newsom's curfew orders	Other	Conservative
t3_jznunb	AOC suggests criticizing socialism is racist after reeling Dem colleagues blast radicalism	Other	Conservative
t3_jzikib	‘You’re Such A D**k’: New Jersey Gov Confronted Eating Maskless Outside With His Family	Other	Conservative
t3_jzr86o	Michigan board certifies Nov. 3 election results as one GOP canvasser dissents	Other	Conservative
t3_jzmmir	Climate Change Alarmist Harrison Ford Seen Landing Private Jet to Pick Up Son Ahead of Thanksgiving	Other	Conservative
t3_jzmo2n	U.S newspapers got paid millions to publish Chinese propaganda	Other	Conservative
t3_jzbvjq	‘You Can’t Enforce’ Thanksgiving Lockdowns, New Mexico Governor Says	Other	Conservative
t3_jzl8e6	Police Union Tells Embattled New York Subway Riders 'You're on Your Own' amid the recent rash of shoving incidents by unhinged assailants	Other	Conservative
t3_jzgqo5	“Burn It Down” -- Activists in Seattle want to abolish police, prisons, and courts.	Other	Conservative
t3_jzl2bz	Media Unveils Bold New Plan to Win Latino Support by Calling Them Racist	Other	Conservative
t3_jzd2gt	Late Justice Scalia's son blasts Harris for insinuating Catholic charity a hate group	Other	Conservative
t3_jzl07r	George Takei: ‘I Want to Live in a Country Where Kaepernick is Seen as a Hero and Kyle Rittenhouse Is Seen as a Terrorist’	Other	Conservative
t3_jzpsuv	Wauwatosa Mayor: "Guns have no place in shopping malls or other places in which crowds of people gather. Mayfair has a strict no-gun policy. If the shooter had complied with that policy, no one would have been hurt yesterday."	Other	Conservative
t3_jz9ec9	UK Physician - "Frankly, if it had not been for mainstream media and the government, I would not have even noticed there were a pandemic. I experienced no excessive dying, and no excessive becoming seriously ill."	Other	Conservative
t3_jzakuc	Michael Flynn: Sidney Powell temporarily suspended from Twitter	Other	Conservative
t3_jznw1e	Bill Gates Smears Parler and its Users	Other	Conservative
t3_jz8p9z	Sidney Powell Releases Statement	Other	Conservative
t3_jzb775	Dominion Voting Systems says it is 'physically impossible' for their machines to switch votes for candidates	Other	Conservative
t3_jzo4qi	AOC Suggests Criticizing Socialism Is Racist After Reeling Dem Colleagues Blast Radicalism	Other	Conservative
t3_jz96qb	Mass Protest at CNN: Your Fake News Gig Is Up	Other	Conservative
t3_jzlvqt	If the 2020 Election Was Held in a Foreign Country, the State Department and Western Media Would Declare it "Fraudulent" -	Other	Conservative
t3_jzlp06	Majority say they want GOP in control of Senate: poll	Other	Conservative
t3_jzjqn4	HISTORIC: Netanyahu Meets Saudi Prince in Saudi Arabia, Reports Say	Other	Conservative
t3_jzbq3q	Oregon governor backs idea of alerting authorities on neighbors who violate COVID-19 restrictions	Other	Conservative
t3_jzdp3j	Civil Disobedience: WATCH Angry business owners RESIST Cuomo's enforcement visit by Health Dept, Sheriff ⋆ The Savage Nation	Other	Conservative
t3_jzbcek	Do as I say, not as I do: California's top Democrats display their hypocrisy over COVID-19	Other	Conservative
t3_jzgnxw	WHO Director Dr. Tedros Moves the COVID-19 Goalposts Right Off the Playing Field. He wants you to know that vaccines won’t really change anything in response to COVID-19. His statement defies the management of any virus and there is no science to support it.	Other	Conservative
t3_jze123	After Pelosi Claims She Wants To Provide Relief – Records Show 40 Times The House Democrats Blocked Relief Aid	Other	Conservative
t3_jzbqfd	The U.S. has withdrawn from the Treaty on Open Skies	Other	Conservative
t3_jzit8p	America Needs A Special Counsel To Investigate Election Integrity, Stat -- With credible allegations of fraud compounding by the day, the American people deserve a special counsel investigation to set the record straight.	Other	Conservative
t3_jzdeqx	Statement from Sidney Powell to "WE THE PEOPLE"	Other	Conservative
t3_jzjdwn	Union Bosses Sink Bernie Sanders as Labor Secretary	Other	Conservative
t3_jziasi	Israel’s Netanyahu, Saudi Crown Prince Hold First Known Meeting	Other	Conservative
t3_jzn6nr	Progressives Declare War on Asians, Meritocracy and STEM - Asian Dawn	Other	Conservative
t3_jzfo1b	In Oregon Crack cocaine was legalized in a November 3rd referendum along with all other illicit drugs while plastic straws were prohibited. The Oregon Health Authority however wants people to stay safe and remember to pull your mask back into place between puffs on your crack pipe.	Other	Conservative
t3_jzpa5n	Dominion CEO Admits In Testimony This Year to Congress: Machines Rely On Chinese Parts From 'Screen Interface Down To Chip Level'	Other	Conservative
t3_jztb40	Stacey Abrams: ‘More than 750,000’ Georgians Requested Ballots for Runoff	Other	Conservative
t3_jzphli	Fury Erupts as George Floyd Exhibit Opens at Holocaust Museum	Other	Conservative
t3_jzntuf	Victor Davis Hanson: A Time of Chaos Upon Chaos Atop Chaos -- There is a series of battles to come in January 2021, in 2022, and in 2024 that will be definitive, if the chaos of 2020 does not become even more chaotic.	Other	Conservative
t3_jzjsi1	Viral Video: NJ Gov. Phil Murphy Confronted At Restaurant For Not Wearing Mask	Other	Conservative
t3_jznvgj	Another Democratic Governor Shuts Down State, Orders Masks Indoors And Outdoors	Other	Conservative
t3_jzl9we	Annoyed ABC Scolds Americans 'Not Listening,' Visiting Family on Thanksgiving	Other	Conservative
t3_jzky42	Portman: No proof of mass fraud that would change election result	Other	Conservative
t3_jzd21w	A dozen compelling allegations of voting irregularities in 2020 election	Other	Conservative
t3_jzmoe1	In threat to Iran, US sends heavy bombers to Middle East via Israel	Other	Conservative
t3_jzg5xr	California School District Bans Use of Classic Books in Classroom Over Racism Complaints	Other	Conservative
t3_jz9kq9	Guatemalan protesters storm Congress, light building on fire as clashes with government forces escalate	Other	Conservative
t3_jzlm2e	Newsom pressured to pick ‘woman of color’ to fill Senate seat. Former San Francisco Mayor Willie Brown is pushing Maxine Waters among others.	Other	Conservative
t3_jznk67	Antiracism Icon Robin DiAngelo Paid More Than Black Woman for Same Job	Other	Conservative
t3_jzm8ty	George Soros-linked election software company lies about ties with Dominion | One America News Network	Other	Conservative
t3_jznztj	Liberals’ race rhetoric is a power grab	Other	Conservative
t3_jzn6ft	Propaganda, Election Fraud and the Death of Journalism	Other	Conservative
t3_jzfv1z	Lib Priest's Bashing of ACB's Latest Decision Accidentally Admits We Were Right All Along	Other	Conservative
t3_jzajlb	Dr. Michael Yeadon, former VP of Pfizer, explains in video why the pandemic is essentially over	Other	Conservative
t3_jzrnbw	Pennsylvania bans alcohol sales at bars, restaurants on Thanksgiving Eve as COVID cases climb	Other	Conservative
t3_jzpk3o	Pennsylvania Bans Sale Of Alcohol At Bars, Restaurants Ahead Of Thanksgiving	Other	Conservative
t3_jzot34	Georgia extends use of absentee ballot drop boxes for Jan. 5 runoff amid surge in requests	Other	Conservative
t3_jzhkq9	Banks Give Black-Owned Businesses Advantage on Supply-Chain Finance Terms. Programs spring from multibillion-dollar commitments banks made to expand lending and investment after Black Lives Matter protests this year	Other	Conservative
t3_jz9gxv	Nicolas Sarkozy, former President of France goes to trial on charges of corruption	Other	Conservative
t3_jzqcst	The 2005 Carter-Baker Report Predicted Election Madness 15 Years Ago	Other	Conservative
t3_jzk9ow	LORD SUMPTION: Wrong for government to tell us what to do at Christmas	Other	Conservative
t3_jzpjnf	Qantas Airlines First to Require COVID Vaccine for International Flyers: 'That’s a Necessity'	Other	Conservative
t3_jzl4xr	DC bill wants to allow kids to take vaccines without parents	Other	Conservative
t3_jzr7e8	ICYMI: Diebold, the company accused of rigging the 2004 election for Bush, was bought out by Dominion in 2010.	Other	Conservative
t3_jzl009	The Latest Memorial to George Floyd Is in a Holocaust Museum	Other	Conservative
t3_jzsv09	AOC calls out Kyle Rittenhouse's $2 million bail release as 'protection of white supremacy'	Other	Conservative
t3_jzjms3	China Proposes Global 'Track and Trace' System for Travel Reset	Other	Conservative
t3_jznk71	CDC Advises Family Households To Ostracize College Students Returning Home For Thanksgiving	Other	Conservative
t3_jzmb9p	House GOP wins suggests party growth, possible majority in 2022 | One America News Network	Other	Conservative
t3_jzl531	Will Republicans Learn From The 2020 Election?	Other	Conservative
t3_jzozry	Florida Holocaust Museum sparks fury by adding George Floyd exhibit	Other	Conservative
t3_jzp9ef	Business Owners March Against Governor Murphy's Executive Orders	Other	Conservative
t3_jzp1ge	Election Fraud Is Too Important To Be Left To Conspiracy Theorists	Other	Conservative
t3_jzqot1	COVID-19 vaccines could be required for certain jobs	Other	Conservative
t3_jzk30j	Kevin McCarthy: Voters Have Rejected Pelosi's 'Socialist' Agenda	Other	Conservative
t3_jzq127	Tennessee Ban On Abortions Due To Down Syndrome, Race, Sex Partially Upheld By Appeals Court	Other	Conservative
t3_jzjhvd	5 NBA Players Meet With Pope Francis To Talk Social Justice	Other	Conservative
t3_jzmf8v	: Election 2020 -- Are we witnessing the beginning of the end of wokeism?	Other	Conservative
t3_jzl8yl	Pope Francis hosts NBA players to talk social justice.	Other	Conservative
t3_jzj86s	France: Macron and his Islamic Rivals | Jayzoq	Other	Conservative
t3_jzsnjz	CNN Drowned Out by Protesters Chanting 'CNN Sucks! CNN Sucks!'	Other	Conservative
t3_jzrtf9	The Lancet says the PCR false positive rate is unknown but could be up to 4%. Others have suggested 5%. We are testing 1.5 million a day. That's a FP rate of 75,000 a day if the 5% is true. The more we test the more FP there are.	Other	Conservative
t3_jzrfch	The Government's Reckless Student Lending is Creating a Budget Hole Akin to the 2008 Crisis, New Analysis Shows	Other	Conservative
t3_jzpv35	School allows boy into girls locker room while girls cry their privacy will be violated	Other	Conservative
t3_jziqzk	Inside the Fight to Abolish Police in Philadelphia	Other	Conservative
t3_jzh16z	"Kracken" is a ClA Hacking Program	Other	Conservative
t3_jz8cld	Wikileaks Dump - “KRAKEN” is a CIA Hacking Program	Other	Conservative
t3_jzqcvx	2005 Carter-Baker Report Could Have Averted Problems With 2020 Voting	Other	Conservative
t3_jzho94	Watergate reporter Carl Bernstein lists 21 GOP senators	Other	Conservative
t3_jzpn2o	Top 50 Conservative Colleges	Other	Conservative
t3_jzo284	Conservatives, speak up	Other	Conservative
t3_jznv4k	These NHS Staff Were Told The Rushed Swine Flu Vaccine Was Safe, And Now They’re Suffering The Consequences	Other	Conservative
t3_jzn0r6	Official How-To Guide for Safely Celebrating Thanksgiving in 2020. By following our guide, readers can comfortably socialize with their friends and family instead of living in isolation from their loved ones because of a virus with a 99.997% survival rate.	Other	Conservative
t3_jzit58	Who’s Afraid of the Common Good?	Other	Conservative
t3_jzie34	Help! Pollsters Have Fallen and They Can't Get Up!	Other	Conservative
t3_jztzwp	James Freeman: U.S. Media and Covid	Other	Conservative
t3_jzswjy	Lawmakers, Experts Warned of Election Vulnerabilities Years Ago	Other	Conservative
t3_jzs9qp	Private employers have qualified right to mandate employee COVID-19 vaccination	Other	Conservative
t3_jzr3q8	Joe Nocera: Schools Don’t Spread Covid. Teachers' Unions Don’t Care.	Other	Conservative
t3_jzl0wn	Why not ‘My Fuhrer’? Appeals court grills public college on forcing professor to call male student ‘miss’	Other	Conservative
t3_jzipm0	Democrats plan to bring back earmarks. Ready the pork barrel!	Other	Conservative
t3_jzfmoi	AstraZeneca; Covid Vaccine 70% Effective	Other	Conservative
t3_jzpb5r	Study: Canceling Student Loan Debts Won't Significantly Stimulate Economy	Other	Conservative
t3_jznr75	The Antifa Playbook	Other	Conservative
t3_jzmb1i	Here Is The Evidence	Other	Conservative
t3_jzjndl	Op-Ed: 2020 Election Results Show No Irregularities, By Ruth Bader Ginsburg	Other	Conservative
t3_jzji2k	What Makes Internet Trolls Tick?	Other	Conservative
t3_jzfyhc	Making sense of the news about Sidney Powell	Other	Conservative
t3_jztyv8	NBA Players Meet With Pope Francis At The Vatican To Discuss Social And Economic Justice	Other	Conservative
t3_jzrtr8	Florida might not force you to get a COVID vaccine — but it can. Here's why	Other	Conservative
t3_jzmp24	Taxes are Too High Right Now	Other	Conservative
t3_jzltdg	Christianity and the Future of American Conservatism | Mark Movsesian	Other	Conservative
t3_jzfytp	It's getting bad out there better cancel 4th of July.	Other	Conservative
t3_jzd882	Democrats Do Drama – We Need to Stay Resolved, Disciplined, and Driven	Other	Conservative
t3_jz8xxm	The 10 Best Anti-Riot Memes	Other	Conservative
t3_jzu1f1	Bill McGurn: A Heap of Thanksgiving Hypocrisy	Other	Conservative
t3_jzrilt	Emma Hogan: In an age of uncertainty, the 1980s look defiant	Other	Conservative
t3_jzqbom	Bloomberg editorial: Canceling student loan debt is a bad idea	Other	Conservative
t3_jzf5o6	Ricky Schroder poses with accused Kenosha shooter after helping fund his $2 million bond	Other	Conservative
t3_jzc1yg	Twitter to Open New ‘Spaces’ Feature First to ‘Women’ and ‘Marginalized’ Voices	Other	Conservative
t3_jz8xm9	L.A. County suspends outdoor dining at restaurants as coronavirus surges	Other	Conservative
t3_jzm76o	Why Fewer People Should Go to College	Other	Conservative
t3_jzixcy	Are Covid Patients Gasping ‘It Isn’t Real’ As They Die?	Other	Conservative
t3_jzfj32	Lee Smith: Behind the Scenes, Obama Never Left	Other	Conservative
t3_jztc6y	Apple lobbying against Uighur Forced Labor Prevention Act: Report	Other	Conservative
t3_jzt4eg	Prohibition in Pennsylvania: Governor halts alcohol sales day before Thanksgiving	Other	Conservative
t3_jzsvpu	Conservative Activist on Georgia's Second Recount: The Most Important Part Is Matching Signatures	Other	Conservative
t3_jzryh4	Charles Moore: The lack of opposition to (UK) Johnson’s Green Crusade is a sure sign of trouble	Other	Conservative
t3_jzqv4e	Former Pfizer Chief Science Officer: "Pandemic is Over", "Second Wave" based On False-Positive Tests	Other	Conservative
t3_jzjmci	Unemployment benefits are the worst kind of pandemic relief	Other	Conservative
t3_jzfdy5	Ilana Mercer: Simplest Source of Voter Fraud Is Baked Into the System (Noncitizen voters)	Other	Conservative
t3_jzad11	Henry Cabot Lodge on conservatism as the "great secret" of American political success—and the fundamental errors that define progressivism	Other	Conservative
t3_jz91f8	Hyperinflationary Great Depression Coming – Economist John Williams (Because of Loony Liberal Lockdowns?)	Other	Conservative
t3_jzu7dj	Mayor de Blasio’s New York City in chaos	Other	Conservative
t3_jzk8tb	George Soros-Linked Election Software Company Lies About Ties With Dominion	Other	Conservative
t3_jzfqw0	The “OFFICE”...	Other	Conservative
t3_jzsvyh	Oregon Gov. Brown says people should call the police on their neighbors if they see COVID restriction violations	Other	Conservative
t3_jzcdl4	Betsy Devos Department of Education: A Teacher's Defense	Other	Conservative
t3_jzb61v	Fighting Words	Other	Conservative
t3_jz9z58	Dems’ twisted vaccine politicking may put our recovery at risk: Devine	Other	Conservative
t3_jzugnr	Tennessee Court of Appeals upholds law banning abortions for Down syndrome! Life is winning!	Other	Conservative
t3_jzt3qq	John Cleese Accused Of Transphobia After Expressing Support For J.K. Rowling	Other	Conservative
t3_jzh8qm	All Americans Should Celebrate Thanksgiving Despite Covid	Other	Conservative
t3_jzubg1	Gerard Baker: Obama think's he's Moses leading us to the ‘Promised Land’ (Funny read)	Other	Conservative
t3_jzfz2b	Health Care is Not a Right, but a Service. We Must Remind Leftists of that Fact	Other	Conservative
t3_jztms2	Exhibit Q Ramsland Affidavit – #7, Att. #1 in Wood v. Raffensperger (N.D. Ga., 1:20-cv-04651) – CourtListener.com	Other	Conservative
t3_jzta45	Mark Levin educates on civil litigation for the ignorant talking heads	Other	Conservative
t3_jztzqb	Poll: Should state governments regulate how people can celebrate holidays during COVID-19?	Other	Conservative
t3_jztbif	Coronavirus updates: Los Angeles County closes in-person dining; 20M could get vaccine in December; CDC warns against cruise ships	Other	Conservative
t3_jz8798	Obama can't credibly racialize his party's failures - Former President Barack Obama continues to believe the world revolves around him.	Other	Conservative
t3_jz89z7	National Security Source Confirms “A Piece of Hardware Has Been Secured” in Germany	Other	Conservative
t3_jzt4d8	Illinois removes thousands of available hospital beds from state COVID-19 database	Other	Conservative
t3_jzrwbz	Political Lists and Facsisn: The Lincoln Project Terrorizes the Opposition	Other	Conservative
t3_jzav7h	Article from Sidney Powell	Other	Conservative
t3_jzsumw	Obama Talks and Talks and Talks About His Memoir and His Greatness. -- The Former President is fixated on “truth”—something that mattered very little to him during his presidency.	Other	Conservative
t3_k05bxt	Oregon Gov: People Should Report Neighbors’ Thanksgiving Gatherings With Too Many People	Other	Conservative
t3_k0c5qz	John Cleese, under fire from woke mob, hopes they all 'fry in their own sanctimoniousness and narcissistic posturing'	Other	Conservative
t3_k02cs1	California Pastor Temporarily Turns His Chapel Into a Strip Club to be Deemed "Essential"	Other	Conservative
t3_k06r8d	Congress Just Got Swept By A Red Wave – Out Of 27 ‘Toss-Up’ House Races, The Republicans Took All Of Them	Other	Conservative
t3_k08ub0	Pennsylvania Certifies Nov. 3 Election Results, Gov. Wolf Says	Other	Conservative
t3_k06tdi	Sidney Powell Keeps Telling Kids Their Christmas Presents Are Going To Make Their ‘Freaking Heads Explode’	Other	Conservative
t3_jzyr3p	‘No Masks, All Indoors’: Award-Winning Journalist Claims 22 People Attended Newsom Dinner, Not 12, $15k Bar Bill	Other	Conservative
t3_k06nuj	Feinstein drops out of Democratic leadership in Senate	Other	Conservative
t3_k02344	Mitt Romney Should Be Getting Nervous – His Senate Seat Could Be Challenged By Conservative Actor Scott Baio	Other	Conservative
t3_k07t2w	Journalist says Gavin Newsom's COVID-snubbing dinner party was far worse than reported: Attendees now 'privately laughing' at controversy'	Other	Conservative
t3_k068ed	Michigan County Board Approves Resolution to Impeach Gov. Whitmer - Truly Times - Conservative News	Other	Conservative
t3_k08m37	Fifth Circuit Permits Texas and Louisiana to Defund Planned Parenthood	Other	Conservative
t3_k08yfx	State Governor Frees All Drug Dealers To Provide Prison Space For Families Celebrating Thanksgiving	Other	Conservative
t3_k0dqhe	Chinese Government Lays Off Entire Propaganda Team As American Media Doing Their Job For Them	Other	Conservative
t3_jzyx43	Oregon Imposes 30 Days In Jail For Thanksgiving Gatherings	Other	Conservative
t3_k03hok	Hours After Gov. Newsom Enacts California Order – “Curfew Crashers” In 16 Cities Flood The Golden StateStreets	Other	Conservative
t3_k07311	Virginia Study: Remote Learning Damaging Students’ Education	Other	Conservative
t3_k07dth	US can kill its own citizens without review when state secrets are involved, DOJ lawyer argues	Other	Conservative
t3_k031hj	Federal Appeals Court: Texas, Louisiana Can End Planned Parenthood Funding	Other	Conservative
t3_k08gcr	Pope Francis backs George Floyd protests, slams COVID-19 skeptics in book	Other	Conservative
t3_jzzgdh	Seattle: Another 34 police officers leave as downtown businesses report an increase in crime	Other	Conservative
t3_jzx045	Media on All Out Assault on Governor Noem as she refuses to issue mask mandate	Other	Conservative
t3_jzvqkn	Pope Francis book backs George Floyd protests, blasts virus skeptics	Other	Conservative
t3_k07swg	Some college students plan to 'educate' conservative family members about their political, social views over Thanksgiving	Other	Conservative
t3_k06lxq	Feinstein to Step Down as Ranking Judiciary Dem after Progressive Disappointment with Barrett Hearings	Other	Conservative
t3_k00wfd	Walmart Thanks Government For Completely Obliterating Their Small Business Competition	Other	Conservative
t3_k0f9xd	OANN suspended from YouTube for 'misinformation'	Other	Conservative
t3_k02srs	Get ready for major backlash to the next wave of lockdowns. As public-health experts have largely jettisoned any claim to public trust.	Other	Conservative
t3_k0c84l	Rand Paul says the 'vast majority' of voting must be in person to mitigate potential for fraud	Other	Conservative
t3_k0986c	McConnell Pushing Forward, Relentlessly Confirming Judges	Other	Conservative
t3_jzx9o8	Gov. Cuomo floats hosting his elderly mom for Thanksgiving, sparks uproar	Other	Conservative
t3_k096u0	WALSH: New HBO Documentary On ‘Transkids’ Accidentally Tells Disturbing Truth	Other	Conservative
t3_jzzutr	Breaking: Founder of Overstock.com 100% confident that election was rigged and can prove it forensically through code..	Other	Conservative
t3_k08pkj	Twitter decided to censor posts that ‘could undermine faith’ in election process before a single vote was cast on election day	Other	Conservative
t3_jzvn0g	Gov. Andrew Cuomo Calls Sheriffs Who Won't Enforce His Thanksgiving Restrictions Dictators	Other	Conservative
t3_k0aqfo	Republican Sen. Perdue says he would fly AOC to Georgia to campaign for his Democratic opponent.	Other	Conservative
t3_k00v11	To Avoid Thanksgiving Restrictions, Family Having Several "Clumps of Cells" Over Instead	Other	Conservative
t3_k035iz	Patrick Byrne of Overstock: This election was rigged — deeply	Other	Conservative
t3_k05ash	Alleged Money Trail from China to Georgia Hints at Rigged Results and Certification Flip-Flops	Other	Conservative
t3_k08gpc	Why Does Gov. Andrew Cuomo Continue To Single Out Jews?	Other	Conservative
t3_k0do6x	CNN’s serious journalist Bryan Stelter says conservatives joining Twitter alternative, Parler, is a "threat to Democracy"	Other	Conservative
t3_k0b75h	Just Hours After Being Placed In Cuomo's Possession, Emmy Statue Dies Of COVID. "The Emmy was placed in a nursing home for safekeeping and almost immediately contracted the virus, passing away just hours later"	Other	Conservative
t3_k0cy07	After Fending Off Pandemic Challenger, Planned Parenthood Retains Title For Most Americans Killed In 2020	Other	Conservative
t3_k06dee	Tlaib denounces Pompeo's decision to recognize BDS as antisemitic	Other	Conservative
t3_k0d7ge	Group files emergency petition in Wisconsin after finding 150,000 potentially fraudulent ballots	Other	Conservative
t3_k0c6kn	In Seattle, 34 more officers ditch the force as city slashes police budget for a second time	Other	Conservative
t3_k0353k	Are the Republicans Writing Their Own Political Obituaries? Having your win stolen blatantly and yet concede it without a fight is not a sign of the moral high ground. Instead, it is a death sentence to your political future.	Other	Conservative
t3_k0deuw	Gov. Cuomo Cancels Thanksgiving with His 89-Year-Old Mother After Backlash	Other	Conservative
t3_k08zt9	Post-George Floyd, a Wave of 'Anti-Racist' Teaching Sweeps K-12 Schools Targeting 'Whiteness'	Other	Conservative
t3_k04l2n	Brits Who Test Negative For Covid-19 Could Get 'Freedom Pass' To Avoid Restrictions	Other	Conservative
t3_k05hsh	Maryland GOP Gov. Hogan: 'No Constitutional Right To Walk Around Without A Mask' (Video)	Other	Conservative
t3_k0d2ok	New Arkansas bill to criminalize nearly all forms of abortions	Other	Conservative
t3_k056rr	Strategic Disinformation and the 2020 Election -- The intelligence community is no longer prepared to defend America against foreign deception and disinformation.	Other	Conservative
t3_k0advf	Election fraud to any degree destroys trust	Other	Conservative
t3_k030ei	Democratic Member Seeks To Disbar Two Dozen Lawyers Challenging Election Results	Other	Conservative
t3_k0a7jl	Pushed Out? Feinstein Stepping Down As Lead Democrat On Judiciary Committee Following Left-Wing Criticism	Other	Conservative
t3_k03pge	Americans Across the Nation Are Rising Up Against Draconian Lockdowns	Other	Conservative
t3_k057qr	Democrat Governors are Suicidal -- or They Don’t Believe in Their Own Lockdowns	Other	Conservative
t3_k06qac	Tennessee Democrat Jim Cooper Attacks People With Down Syndrome To Mock Republican Voters	Other	Conservative
t3_jzyhp2	Pentagon Report: China Now Has World’s Largest Navy as Beijing Expands Military Influence - USNI News	Other	Conservative
t3_k086eq	When It Comes to Election Fraud, It's 'Hear No Evil, See No Evil, Speak No Evil'	Other	Conservative
t3_k09j7d	Lord Acton on the enduring significance of the American Revolution	Other	Conservative
t3_k05bqx	Stephen Moore: "Paris Climate Treaty Puts America Last"	Other	Conservative
t3_jzyl5p	One in four Rhode Islanders can't meet basic food needs, food bank's annual report says	Other	Conservative
t3_k0bmn2	Psychologist And Search Engine Expert Robert Epstein: Google Shifted a 'Minimum' of 6 Million Votes in 2020	Other	Conservative
t3_jzyhdn	The Great Relocation: Americans Are Relocating By The Millions Because They Can Feel What Is Coming	Other	Conservative
t3_k096yy	AOC and Ted Cruz clash over stalled COVID-19 relief bill	Other	Conservative
t3_k06pu6	Andrew Cuomo Absolutely Deserves An Emmy Award -- Cuomo is America’s greatest governor on television--and its worst in real life.	Other	Conservative
t3_k06shu	Lone Michigan Canvasser Holdout: 'Whoever Threatens the Most Wins'	Other	Conservative
t3_k01jah	Republican Maryland governor says no one has a 'constitutional right to walk around without a mask'	Other	Conservative
t3_k03tho	War has and is being waged principally against our culture -- against our values, beliefs, and mores. It has been and is against the fundamentals of a healthy society. The assaults are against what’s organic to a vital society: marriage, family, and children, neighborhood and community.	Other	Conservative
t3_k02cf8	Pompeo Predicts ‘Many’ More Mideast Peace Deals: ‘We Broke Glass’	Other	Conservative
t3_k0fh0y	Pennsylvania, Arizona and Michigan state leglislatures to hold hearings on 2020 election	Other	Conservative
t3_k05smd	PA's Thanksgiving liquor sales mandate is just bizarre	Other	Conservative
t3_k06dyp	The Coming Anti-COVID Restriction Backlash	Other	Conservative
t3_jzvxbq	Rudy Giuliani on Break with Sidney Powell: 'We're Pursuing Two Different Theories'	Other	Conservative
t3_k002s3	SCOTUS issues new circuit assignments - “justices can opt to bring cases from their circuit straight to the Supreme Court.”	Other	Conservative
t3_k0btwo	All SUNY Students Must Test Negative for COVID Before Thanksgiving Break: Chancellor	Other	Conservative
t3_jzysdb	Good ol’ progressive liberals pushing for segregation in college universities.	Other	Conservative
t3_k04204	Cooper’s Office Now Claims He Meant To Say All Republicans Are Racist, Not Mentally Disabled	Other	Conservative
t3_k0f82l	Thousands in Georgia Registered at Postal, Commercial Addresses, Portraying Them as Residences, Researcher Says	Other	Conservative
t3_jzxcny	On Coronavirus, We Must Not Allow Politics to Dictate Science - The New American	Other	Conservative
t3_k06z4h	3rd major COVID-19 vaccine shown to be effective and cheaper	Other	Conservative
t3_k05pg0	Border Security is Crucial for National Security	Other	Conservative
t3_k0f5vv	New Congresswoman Creates a Furor by Asking About Her Second Amendment Rights	Other	Conservative
t3_k0e5rw	Black Republican Opponent Expected to Defeat Stockton’s Popular Democratic Mayor Michael Tubbs	Other	Conservative
t3_k0f3x1	New Virginia study finds online schooling is severely damaging students' academic achievement	Other	Conservative
t3_k04xql	Swiss Doctors Asking Vulnerable To Sign “Do Not Resuscitate” Orders	Other	Conservative
t3_k0gnnd	Woke media outlet tries to make a funny video about white stereotypes and it's the most racist thing you'll watch today	Other	Conservative
t3_k0e821	Group Files Emergency Petition in Wisconsin After Identifying 150,000 Potentially Fraudulent Ballots	Other	Conservative
t3_k0e1wa	Errors, 'Scams' Led California To Send Millions In COVID Unemployment Benefits To Prisoners, Death Row Inmates	Other	Conservative
t3_k0dh1k	It doesn't end with COVID. Matt Hancock in the UK wants to use NHS testing system to fight flu after Covid.	Other	Conservative
t3_k0g153	Edward Solomon reverse-engineered the Dominion Voting Algorithm	Other	Conservative
t3_k0fkwk	Republicans should make AOC House Speaker | Spectator USA	Other	Conservative
t3_k0eqx8	US Drafts List of 89 China Firms With Military Ties	Other	Conservative
t3_k0fvav	Cammack: 'Only in America' Could I Go from Homelessness to Congress	Other	Conservative
t3_jzyc64	What Gavin Newsom’s Inevitable Political Doom Means for Democrats - American Greatness	Other	Conservative
t3_k0c74s	Ohio lawmakers say elective medical procedures could be postponed amid ‘exponential’ surge in COVID-19 cases	Other	Conservative
t3_jzwuzq	Cooperate with China or World War 3: Kissinger	Other	Conservative
t3_k0ga53	Allison Pearson: Leftists who dominate our institutions get to define what constitutes offensive behaviour, then they come up with a new “ism”	Other	Conservative
t3_jzzjmx	Covid-19: China pushes for QR code based global travel system	Other	Conservative
t3_k07vyg	Why Philly Gym Owners Are Protesting Un-Real New Regulations	Other	Conservative
t3_k0eo86	CDC talks about COVID Camps	Other	Conservative
t3_k0ayuw	Republican Maryland governor says no one has a 'constitutional right to walk around without a mask'	Other	Conservative
t3_k072ev	International Flyers May Soon Need to Get Virus Vaccinations	Other	Conservative
t3_k00ina	Rudy Giuliani Explains Why He Distanced Himself From Sidney Powell	Other	Conservative
t3_k08gxz	The Skyrocketing National Debt is Highly Problematic	Other	Conservative
t3_k0d6er	Raphael Warnock reportedly said racism is America’s ‘pre-existing condition’	Other	Conservative
t3_k0b1lq	Maryland Gov. Larry Hogan expands coronavirus snitch line: ‘There’s no constitutional right’ to go maskless	Other	Conservative
t3_k06bbf	Risk v. Profit: Uncle Sam needs a better way to budget for federal lending.	Other	Conservative
t3_k0gi2f	Oregon Governor: Snitch On Your Neighbors For Violating Thanksgiving COVID Orders	Other	Conservative
t3_k0geb9	Martin Wolf: What the world can learn from the Covid-19 pandemic	Other	Conservative
t3_k0fxl4	BLM pressures Democrats to embrace bill described as 'roadmap for prison abolition'	Other	Conservative
t3_k0cdgj	Rand Paul: No DOJ Investigation into Funding Behind ‘The Thugs’ Who Attacked Republicans After RNC Event in August	Other	Conservative
t3_k0a425	Ballots cast by the dead emerge in extremely tight Brindisi-Tenney race	Other	Conservative
t3_k00l9s	Where American Workers Donated This Presidential Election	Other	Conservative
t3_k0eqho	Justin Haskins: Democratic socialists grow stronger, weakening Dems with losses in swing districts	Other	Conservative
t3_k0crt9	How to Start Curbing Violent Crime by Lt Col Jeff Cooper	Other	Conservative
t3_k06gh5	Sen. Feinstein to Step Down from Judiciary Committee After Backlash from Progressives	Other	Conservative
t3_k0eqk1	The Corona Virus Pandemic, an Analysis: Part 1 By Dr. Roger Hodkinson (this is the Canadian pathologist who went off in a public health meeting a little while ago)	Other	Conservative
t3_k0gthn	Jason Riley: The Political Class’s Hypocrisy Long Predates Covid-19	Other	Conservative
t3_k0efw5	Women and girls are about to be portrayed in textbooks a lot differently	Other	Conservative
t3_k0b3fu	Dow Jones Surpasses 30,000 for the First Time	Other	Conservative
t3_k0ajdu	University System Mandates 140,000 Students Test Negative For COVID-19 Before They Can Leave For Thanksgiving	Other	Conservative
t3_k0gtyq	The DOJ and FBI will Never Investigate or Prosecute any Democrat.	Other	Conservative
t3_k0d4w6	After Fending Off Pandemic Challenger, Planned Parenthood Retains Title For Most Americans Killed In 2020	Other	Conservative
t3_k0ccod	Redfield projects COVID-19 vaccine to be rolled out by 'end of the second week in December'	Other	Conservative
t3_k0gwq1	Julie Kelly: Something Rotten in Pennsylvania	Other	Conservative
t3_k0gcz7	Melanie Phillips: Covid cronyism shows state machine is broken	Other	Conservative
t3_k0euj2	The new silent majority, watch democrats raise the voting age to 90+	Other	Conservative
t3_k004hg	Ex-MSNBC producer: Andrew Yang was on 'list' of 2020 Dems banned from appearing on Lawrence O'Donnell's show	Other	Conservative
t3_k0gf70	Joseph Ladapo: Too Much Caution Is Killing Covid Patients	Other	Conservative
t3_k0fqw0	Narcissists love being pandemic essential workers They post more about work on social media, feel more important (probably the epidemiologists and pathologists as well)	Other	Conservative
t3_k0fhen	Even social media sites tried to block links to the news.	Other	Conservative
t3_k08ch8	RNC Chair: Democrats used COVID to remove election safeguards	Other	Conservative
t3_k00ilt	Apple Security Chief Offered iPads to Police as a Bribe for Gun Permits, Prosecutors Allege	Other	Conservative
t3_k0fv5x	Man Catches Flu, Dies, From Eating Outside In The Cold To Avoid Getting COVID-19 (satire)	Other	Conservative
t3_k0cgns	Expunging an electoral stain: U.S. voting must re-establish pre-pandemic integrity	Other	Conservative
t3_k0g7ub	The Thieves Who Stole Our Election Got Sloppy	Other	Conservative
t3_k0fw2z	Peer-reviewed hydroxychloroquine study finds 84% fewer hospitalizations among early treated outpatients	Other	Conservative
t3_k0ac7f	Vaccine tracking	Other	Conservative
t3_k0bj4j	On Thanksgiving, Democrats Demand The Ultimate Family Separation Policy -- Life is too short to live it in fear of dying.	Other	Conservative
t3_k0b3oo	AOC Blames Republicans for Democrats Delaying Additional COVID Relief	Other	Conservative
t3_k075oi	Will The Supreme Court Defend Religious Liberty From Pandemic Tyrants?	Other	Conservative
t3_k03w3s	CNN Lets Lincoln Project Stooge Advocate Revoking Republican Canvasser's Legal License	Other	Conservative
t3_jzzqlp	By Every Legal Means Necessary	Other	Conservative
t3_jzvrgz	Chinese Regime's Media Outlet Continues Paying US Media Millions to Publish Its Propaganda. "China Daily’s expenses from May 1 to Oct. 31 this year were above $4.4 million ... around $3.1 million was spent on printing &amp; advertising"	Other	Conservative
t3_k0b9vs	Dick Morris to Newsmax TV: Stats Prove Ballot Stuffing	Other	Conservative
t3_k06k7z	Presidential Election Isn’t Over Yet, Conservative Leaders Say -- Until “every legal vote” is counted.	Other	Conservative
t3_jzvzbu	Hillbilly Elegy': Caught Between Hollywood and a Hard Place	Other	Conservative
t3_jzvn07	Dianne Feinstein Paid the Price for Being Too Nice to Amy Coney Barrett	Other	Conservative
t3_jzvmzj	Guess Who is Having Thanksgiving Dinner With His Elderly Mother?	Other	Conservative
t3_k0cvkl	Get Ready Millennial’s; You’re About To Be Sorely Disappointed with Your Vote	Other	Conservative
t3_k0bv2d	USA Election 2020 Was Rigged: The Evidence - Patrick Byrne	Other	Conservative
t3_k09og9	Violent crime surges as police funding plummets | One America News Network	Other	Conservative
t3_k06l85	Tucker Carlson: Here's how the Democrats 'rigged' the 2020 election	Other	Conservative
t3_k053va	A Quick Tutorial On How Dominion Can Alter Your Vote Straight From The Horses Mouth	Other	Conservative
t3_jzxm2l	Constitutional experts: Fraud could put election outcome in state legislators' hands -- Analysis reveals lawmakers have 'total authority' to select electors	Other	Conservative
t3_jzx8pa	Berlin Woman 'Forgives' African Migrant Who Bit Off Part of Her Face	Other	Conservative
t3_jzvuk4	A Crisis of Trust -- Irrespective of who puts his hand on the Bible at the January 20th inauguration to take the oath of office as president of the United States, we’re sure to experience a troubling crisis of trust in our divided country.	Other	Conservative
t3_k09gfg	Dominion VP Explains How to Alter Votes	Other	Conservative
t3_k04p10	MSNBC Defends Rev. Jeremiah Wright Saying, “Not God Bless America! God Damn America!”	Other	Conservative
t3_jzz54q	They think you're stupid. The Great Reset.	Other	Conservative
t3_jzw4ch	Chinese President Xi Jinping Pushes For Global Tracking System Using QR Codes	Other	Conservative
t3_k03sbw	Tucker Carlson: The 2020 Election Was Not Fair, "The System Was Rigged Against One Candidate"	Other	Conservative
t3_k09x1u	Patrick Byrne of Overstock has been poring through the data: This election was rigged — deeply « JoNova	Other	Conservative
t3_k047n5	Socialism Failed Miserably For The American Pilgrims, Just Like It Does Everywhere -- Private property rights and personal responsibility saved the Plymouth colony from the edge of extinction and laid the economic foundation for a free and prosperous nation.	Other	Conservative
t3_k00976	Started a more lax conservative hang out, not all politics by any means but plenty of channels and All are welcome.	Other	Conservative
t3_jzvyqr	Antiracism Icon Robin DiAngelo Paid More Than Black Woman for Same Job	Other	Conservative
t3_jzvmzc	Poll: Overwhelming Majority Back GOP Senate Majority	Other	Conservative
t3_k0472k	How The New York Times Became A Propaganda Bullhorn For The Left -- ‘The news business is highly competitive. If the leader has abandoned its own standards and history of fair and rigorous reporting, why should the others be any different?’	Other	Conservative
t3_k038hk	A Quick Tutorial On How Dominion Can Alter Your Vote Straight From The Horses Mouth	Other	Conservative
t3_jzvvyt	Socialist delegate proposes all future marijuana tax revenue in Virginia be used for reparations	Other	Conservative
t3_jzvvuu	Gun Grabbers Demand Unprecedented “Executive Actions”	Other	Conservative
t3_jzvmzv	What's Odd About That Story of a Nurse Who Trashed Her Dying COVID Patients	Other	Conservative
t3_k071or	Are they aware that if Thanksgiving gets canceled, it will become a regular work day for millions? **UP NEXT: Why the Left Hates Food**	Other	Conservative
t3_k0427y	Court: Texas, Louisiana Can End Planned Parenthood Funding	Other	Conservative
t3_jzv50n	HBO: ‘I’m A Little Shy’, Shows 4-Year-Old boy Prompted To say he's a Girl	Other	Conservative
t3_jzw41k	Pope's Encyclical Is Like Hindu Scriptures'	Other	Conservative
t3_jzvcz2	Removal of Election Safeguards in Arizona Eroded Voter Integrity: Tea Party Official	Other	Conservative
t3_jzxo5l	Dick Morris: Stats Prove Ballot Stuffing	Other	Conservative
t3_jzvmmo	Explosive: New Data Points to VOTER FRAUD in Montgomery County, PA	Other	Conservative
t3_jzzmvb	Democrats Push To Keep Schools Closed So Kids Will Be Dumb Enough To Accept Socialism	Other	Conservative
t3_k0r668	Fox News daytime ratings drop by 32% in two weeks since the election	Other	Conservative
t3_k0rwgx	‘Transhood’ Documentary Shows Parents Brainwashing 4-Year-Olds Into Transgenderism -- New HBO documentary depicts parents propagandizing their children in radical gender theory and robbing them of life in their natural bodies.	Other	Conservative
t3_k0j3lb	Several employees cried when they learned their company would be publishing Jordan Peterson's new book	Other	Conservative
t3_k0jdb0	NYC Mayor de Blasio fines synagogue $15K for massive secret wedding, says house of worship will be closed down if there's 'any further illegal activity'	Other	Conservative
t3_k0rvsa	A 90-Year-Old Woman Killed Herself To Avoid Another COVID-19 Lockdown. She’s Not Alone -- In a tragic irony, the prospect of another 'life-saving' lockdown has drained some senior citizens of their will to live. Assisted suicides and depression are up.	Other	Conservative
t3_k0sp76	Jack Dorsey: 'Let Me Be Clear: Twitter Is A Platform For ANY And ALL Ideas I Wholeheartedly Agree With'	Other	Conservative
t3_k103xp	Crowd Erupts in Grasps and Laughter at Vote Anomaly	Other	Conservative
t3_k0pzpf	And the Emmy for Most Deaths goes to…	Other	Conservative
t3_k0uva9	TESLA CEO, Elon Musk overtakes Bill Gates to become the world’s second-richest man after his net worth rose by $100B in a year during pandemic	Other	Conservative
t3_k0wr05	Defiant NY gym owner, US Marine rips up $15,000 fine for violating coronavirus restrictions	Other	Conservative
t3_k0o7b1	YouTube Bows to Transgender Activists, Deletes Candace Owens Podcast.	Other	Conservative
t3_k0qupx	Penguin Random House staffers broke down in tears over release of Jordan Peterson book: report	Other	Conservative
t3_k0kdxr	Breaking!! Group Files Emergency Petition in Wisconsin After Identifying 150,000 Potentially Fraudulent Ballots found by statistician Matthew Braynard and mathematician Steven Miller. (New video in comments with complete statistical results in all contested states!)	Other	Conservative
t3_k0y9ro	Ballot Chain of Custody Destroyed in Delaware County, PA	Other	Conservative
t3_k0x58b	After warnings to avoid travel, Denver Mayor, Mike Hancock flies to visit family for Thanksgiving	Other	Conservative
t3_k0yua3	BREAKING: Judge Blocks Pennsylvania Certification!!!	Other	Conservative
t3_k0jc0r	California paid up to $1 billion in fraudulent unemployment claims to prisoners — including death row inmates	Other	Conservative
t3_k0q9xh	Appeals Court Rules Texas, Louisiana Can Cut Medicaid Funding to Planned Parenthood	Other	Conservative
t3_k0jd2p	New Virginia study finds online schooling is severely damaging students' academic achievement	Other	Conservative
t3_k0jb4k	Vermont to question schoolchildren over Thanksgiving gatherings, and require quarantine for violators	Other	Conservative
t3_k0z94o	Governor Newsom Orders Police To Go Door To Door Arresting Anyone Not Depressed And Alone	Other	Conservative
t3_k0wqao	Black Lives Matter Leader Killed in Carjacking	Other	Conservative
t3_k0usrg	Gov. Andrew Cuomo blasts NYPD for refusing to enforce Thanksgiving restrictions: Those people aren't real law enforcement officers	Other	Conservative
t3_k0r8zj	Now that fascism has been defeated in America, we can finally enforce COVID lockdowns without resistance. Our nation is finally free to lockdown to save ourselves from a virus with a .001% fatality rate.	Other	Conservative
t3_k0xw1a	PENNSYLVANIA "Judge Patricia McCullough ordered the state to not take any further steps to complete the certification of the presidential race... She also blocked the certification of *ALL* the other election results."	Other	Conservative
t3_k0zvm1	Pennsylvania state judge sides with GOP, halting election certification	Other	Conservative
t3_k0wfq1	Judge Blocks Certification of Pennsylvania Election Results	Other	Conservative
t3_k0r5g3	Staff of Canadian publishing company reportedly cry over decision to publish Jordan Peterson's new book	Other	Conservative
t3_k11fhk	Barack Obama accuses Republicans of creating 'sense that white males are victims'	Other	Conservative
t3_k0zfys	Judge Blocks Certification of Pennsylvania Election Results	Other	Conservative
t3_k0tcaw	Michigan ramps up threats to prosecute vote-fraud WITNESSES	Other	Conservative
t3_k122cs	Rudy Guiliania and Ellis nail it at the legislature voter fraud hearing in Pennsylvania	Other	Conservative
t3_k0sub3	Forcing The Sick And Elderly To Die Alone Is Crueler Than COVID-19	Other	Conservative
t3_k0mhzq	Lin Wood Subpoenas Georgia Officials For Video Evidence	Other	Conservative
t3_k0wq8d	Buildings Lit Up Blood Red to Protest Christian Persecution	Other	Conservative
t3_k0rnmx	Ted Cruz Goes Head To Head With Queen AOC – She Blames Republicans For Relief Stalemate, But Ted Spotlights Their Filibuster	Other	Conservative
t3_k0whvf	Sidney Powell To File Lawsuit Wednesday in Georgia Alleging Massive Voter Fraud	Other	Conservative
t3_k0miwa	Patrick Byrne lays out summary of the Dominion-related evidence he has provided Sidney Powell ahead of her filing suit in GA. While additional angles of attack are hinted at by Powell, this is what she's working from regarding Dominion.	Other	Conservative
t3_k0jco2	In GA, during (late?) Sept, Dominion’s radical Leftist Eric Coomer made a “critical software change” to GA’s Dominion voting machines “without adequate testing or certification from the U.S. Election Assistance Commission”. From this 9/29/20 AJC story	Other	Conservative
t3_k0rvcr	Following The Election, Facebook Tightens Choke On News Outlets It Disagrees With -- Sources such as CNN, The New York Times, NPR, and others benefitted from Zuckerberg’s changes, receiving more traffic and distribution on the site while conservative news artificially lost page views and reach.	Other	Conservative
t3_k0kguy	OAN Responds After YouTube Temporarily Bans, Demonetizes Outlet Over 'Unlisted' COVID-19 Video	Other	Conservative
t3_k12tyj	Michigan County Commission Backs Gretchen Whitmer Impeachment	Other	Conservative
t3_k0xhuf	Pittsburgh Judge Halts Further Election Certification Steps	Other	Conservative
t3_k11r3w	WATCH: Voter Fraud and Election Meddling Evidence Floods Social Media	Other	Conservative
t3_k0z0wc	Thousands of "Votes" in Georgia Used False Address	Other	Conservative
t3_k133fs	Hungary PM Orban denounces George Clooney as a puppet of Soros	Other	Conservative
t3_k0zj9d	New ‘Study’ Claims ‘Far-Right Terrorism’ is ‘Bigger Threat to West Than Islamic State’	Other	Conservative
t3_k0lvqq	Democrats keep getting caught breaking their own coronavirus rules	Other	Conservative
t3_k0wkx2	“It’s a good day for freedom” - South Dakota’s government is not taking the lead in mandating CDC protocols	Other	Conservative
t3_k0k6y8	New Mexico governor shuts down grocery stores for two weeks	Other	Conservative
t3_k11qj5	Gun-toting Congresswoman-elect Lauren Boebert may carry Glock at Capitol	Other	Conservative
t3_k0zykq	Portland's Black BLM Activists Say They're Done With 'White' Antifa, Want 'Separation'	Other	Conservative
t3_k12dov	Denver mayor couldn't even wait a whole hour to fly to Mississippi for Thanksgiving after warning people to 'avoid travel, if you can'	Other	Conservative
t3_k0sz2v	Nevada Lawsuit Claiming Illegal Ballots Cast Has a Trial Date December 3rd	Other	Conservative
t3_k109jk	Data scientist slams 'inherently biased' media for glossing over COVID spikes in blue states	Other	Conservative
t3_k0nkgh	Commentary: Harvard Researchers: Nearly Half of Young Adults Showing Signs of Depression Amid Restrictions	Other	Conservative
t3_k11mtb	Black Lives Matter activist who helped lead Louisville marches shot dead	Other	Conservative
t3_k0lp3i	Republicans Sue to Stop Wisconsin Vote Certification	Other	Conservative
t3_k0l6o7	Kamala's Replacement In the Senate Could Be Determined By a Critical Person From Her Past: Former San Francisco Mayor and Assembly Speaker Willie Brown	Other	Conservative
t3_k13x2m	Pennsylvania witnesses allege massive amount of fraud in today's hearing.	Other	Conservative
t3_k0xjty	Judge Blocks Certification of Pennsylvania Election Results Until Friday Hearing	Other	Conservative
t3_k11u1c	ICE says double-murder suspect was protected by California sanctuary city	Other	Conservative
t3_k0yrcc	Thousands in Georgia Used False Address For Voting: Researcher	Other	Conservative
t3_k0w3nt	BREAKING: TREASON: GA Gov. Kemp and CA Gov. Newsom bought off by communist China in covid supplies kickback and money laundering schemes	Other	Conservative
t3_k0kfnp	Is fame going to Gov. Andrew Cuomo’s head?	Other	Conservative
t3_k0xv3k	Depression rate in the United States triples during COVID pandemic, research shows	Other	Conservative
t3_k0pvj3	Sharyl Attkisson on Big Tech Censorship: Sheep Are Happy to Live in Artificial Reality	Other	Conservative
t3_k0xzxm	Suicide Claimed More Lives in October Than 10 Months of COVID-19 in Japan, Report Shows | Jon Miltimore	Other	Conservative
t3_k0vpyy	Rep. Ilhan Omar turns in worst underperformance for House candidate in the country	Other	Conservative
t3_k0k8t2	U. of Virginia Student Newspaper: Stand Up to 'Racist' Family at Thanksgiving	Other	Conservative
t3_k0k0mj	New Petition filed w/court from AZ GOP: filed a petition today with the Court to allow early inspection	Other	Conservative
t3_k0xooo	Los Angeles County Health Officials Can’t Provide Data To Support Their New Outdoor Dining Restrictions	Other	Conservative
t3_k12rya	Dominion Techie Worked For CCP Military Proxy Flagged By U.S. Govt For ‘Malicious Cyber Activity’	Other	Conservative
t3_k0x6mv	GOP Chair Christiana asks DA to review mail-in ballot envelopes, requests from nursing homes	Other	Conservative
t3_k0x2rj	India ban more Chinese apps and China Criticize | Flash News	Other	Conservative
t3_k0rbgt	‘Faulty Upload’ Changes Unofficial Vote Totals In AZ, Gets Fixed	Other	Conservative
t3_k1493x	Staffers Crying Over Jordan Peterson Book Cured By Forcing Them To Read Jordan Peterson Book	Other	Conservative
t3_k0yhkx	Judge Blocks Certification of Pennsylvania Election Results	Other	Conservative
t3_k0yb0m	Pennsylvania judge halts election certification amid mail-in vote fight	Other	Conservative
t3_k0sv4m	For Anti-Racism, San Diego Schools Will Teach Black, Hispanic Kids Less	Other	Conservative
t3_k0ry42	LA Public Health unable to provide data to support outdoor dining restrictions when pressed by county leader	Other	Conservative
t3_k12j3o	TREASON: GA Gov. Kemp and CA Gov. Newsom bought off by communist China in covid supplies kickback and money laundering schemes	Other	Conservative
t3_k0ssj4	State Republican Steps Down Only Three Weeks After Winning Reelection	Other	Conservative
t3_k0rxlt	CDC may shorten recommended COVID-19 quarantine period to between 7 and 10 days	Other	Conservative
t3_k12kk2	Pennsylvania Judge Halts Further Vote Certification Steps	Other	Conservative
t3_k0zm8v	Sen. Booker Introduces Bill to Transfer Land to Black Farmers	Other	Conservative
t3_k0y29w	Pennsylvania Judge Blocks State From Certifying Election Results For POTUS And All Other Races	Other	Conservative
t3_k0sdff	Poll Shows Growing Democratic Opposition to Cheap Labor Migration	Other	Conservative
t3_k0l4sc	Attorney [Lin Wood] Challenging Georgia Election Outcome Appeals Case	Other	Conservative
t3_k0ryvk	Rigged-election claims in Georgia fuel Republican fears of losing Senate	Other	Conservative
t3_k0xoon	NYC to Have Coronavirus Checkpoints, Sheriff Warns of 'Consequences' for Violating Quarantine	Other	Conservative
t3_k0py58	Europe must not succumb to the Soros network	Other	Conservative
t3_k0m77p	Group Files Emergency Petition in Wisconsin After Identifying 150,000 Potentially Fraudulent Ballots	Other	Conservative
t3_k131gv	Joanna Williams: Covid restrictions show we’re willing to kowtow to authority	Other	Conservative
t3_k0t4on	Georgia voters registered at postal, commercial addresses that appeared to be residential, study	Other	Conservative
t3_k0svpi	WATCH: Fulton County Poll Manager Susan Voyles Recounts Election Improprieties in Georgia Recount	Other	Conservative
t3_k0j8kf	NYC Will Have Covid Checkpoints at Key Bridges and Crossings	Other	Conservative
t3_k13due	Sheriff Donny Youngblood says KCSO will not respond to calls for large gatherings	Other	Conservative
t3_k13i5h	Happy Thanksgiving General Flynn!	Other	Conservative
t3_k12dsg	Dr. Mike is called out for hypocrisy after he's seen partying maskless	Other	Conservative
t3_k0s8dr	BLM leader in Breonna Taylor protests fatally shot in carjacking : TheGrio	Other	Conservative
t3_k12is8	Politicians’ Attacks On Thanksgiving Gatherings Are Not ‘Data-Based,’ Epidemiologists Say	Other	Conservative
t3_k0u3hp	Obama to be honored by PEN America with Voice of Influence Award. During the ceremony, Obama will discuss freedom of expression and the importance of truth in a world of misinformation.	Other	Conservative
t3_k12ail	Analysis - Pennsylvania Judge Blocks Election Certification Over Constitutionality of Mail-In Voting	Other	Conservative
t3_k12z67	Douglas Murray: It's liberal hysteria to think cutting foreign aid will turn UK into an international pariah	Other	Conservative
t3_k12xm8	David Aaronovitch: Infantile obsession with walkouts and martyrdom proves UK’s left isn’t interested in real business of politics	Other	Conservative
t3_k12qox	Judge orders Pennsylvania halt certification of election results as fight over mail-in ballots continues	Other	Conservative
t3_k0wu3h	Los Angeles Bans Outdoor Dining Without Evidence Linking It to New Cases	Other	Conservative
t3_k13lbt	Democrat Jon Ossoff Claims ‘Oversight’ in Omitting Payment from Chinese Communist-Linked Company	Other	Conservative
t3_k12s8z	Florida Democrats Praying to Satan in the House Chamber	Other	Conservative
t3_k0rq2h	Election observers given poop emoji wristbands during vote recount in Wisconsin	Other	Conservative
t3_k14e3n	Pennsylvania state judge sides with GOP, halting election certification	Other	Conservative
t3_k107xb	New Pennsylvania coronavirus measures include stay-at-home advisory, Thanksgiving Eve ban on alcohol sales at bars and restaurants	Other	Conservative
t3_k0ya4t	Penguin Random House staffers broke down in tears over release of Jordan Peterson book: report	Other	Conservative
t3_k0ku9s	Heritage Tech Expert Exposes TikTok’s China Ties on ‘60 Minutes’	Other	Conservative
t3_k0vj5j	Black Lives Matter Leader Calls L.A. Mayor Garcetti A ‘Liberal White Supremacist,’ Speaks Out Against Potential Cabinet Appointment	Other	Conservative
t3_k0ycn2	Pennsylvania governor halts alcohol sales day before Thanksgiving	Other	Conservative
t3_k13rw5	Gov. Cuomo brutally mocked by columnist for accepting Emmy award: 'He was fantastic on television'	Other	Conservative
t3_k0zs54	U.S. Weekly Jobless Claims Jump to 778,000	Other	Conservative
t3_k0wrij	Sidney Powell Wants Zoom Meeting Where Georgia Official Refused Audit	Other	Conservative
t3_k0t9s2	Scott Peterson, CA death-row inmates got COVID-19 benefits in massive scam: report	Other	Conservative
t3_k0t8kd	Massachusetts Democrats Push Unlimited Abortion in Annual Budget -- The amendments would expand abortion after fetal viability and erase parental-consent requirements for minors seeking abortions.	Other	Conservative
t3_k0t2vg	Who Really Runs The Drudge Report?	Other	Conservative
t3_k11igx	5 things to know about NY Gov. Andrew Cuomo’s coronavirus nursing home controversy	Other	Conservative
t3_k0xhc3	California Paid Millions for Unemployment Claims in Prisoners’ Names, Prosecutors Say	Other	Conservative
t3_k11g5p	2020 Election Fraud Evidence Compiled	Other	Conservative
t3_k12w0h	BLM Protester Who Spat in Cop's Face Walks Free After Apology	Other	Conservative
t3_k12vkg	Allister Heath: UK is facing ruin, as a result of Covid Response	Other	Conservative
t3_k0lerd	Urban-Rural Divide Shapes American Culture &amp; Politics	Other	Conservative
t3_k0wi87	The Numbers Don’t Lie (about racial crime rates)	Other	Conservative
t3_k0namr	Treasury, Reserve Bank told Government it could just print money to pay for Covid-19	Other	Conservative
t3_k12qq1	The Year 2020 Was A NightMare; Should We Be Thankful This Thanksgiving?	Other	Conservative
t3_k10fzs	Pittsburgh forms Coronavirus task force to enforce guidelines	Other	Conservative
t3_k0zpa5	Sen. Booker Introduces Bill to Transfer Land to Black Farmers	Other	Conservative
t3_k0o8tl	Sidney Powell plans to file Georgia election-related lawsuit 'no later than tomorrow'	Other	Conservative
t3_k13tpd	Daniel Lacalle: The ‘Great Reset’ and the Risk of Great Interventionism	Other	Conservative
t3_k11jof	The New Woke Times	Other	Conservative
t3_k10vjo	COVID crackdown underway as 'substantial' restrictions coming to NYC	Other	Conservative
t3_k10vha	YouTube Suspends OAN as Liberal Senators Call for Censorship	Other	Conservative
t3_k1043t	New Lockdown a Blow to Philly Restaurants	Other	Conservative
t3_k0yndi	Proposal Seeks To Prohibit Gatherings In LA County As Pandemic Surges	Other	Conservative
t3_k0urr1	New Mexico governor shuts down grocery stores with new public health order	Other	Conservative
t3_k11qjn	This young Cuban man responds to AOC.	Other	Conservative
t3_k0v8sr	NYC's COVID checkpoints are back: Cops out 'in force' at travel spots	Other	Conservative
t3_k1314q	UK Covid Cops Bust Women's Dinner Party	Other	Conservative
t3_k10mvq	One Nation Under Google: How Google Can (and Does) Change Election Outcomes	Other	Conservative
t3_k106hl	U.S. republic needs loyalty, confidence of its citizens	Other	Conservative
t3_k0xfda	WATCH: Uzbekistani Migrant Rescued from Texas Border River	Other	Conservative
t3_k0jz7e	Arizona PROP 208 – Big Tax Increase Possible in Arizona	Other	Conservative
t3_k11ggk	Citi Joins Mastercard In Allowing Transgenders To Use Their ‘Chosen Name’ Without Legal Change	Other	Conservative
t3_k0ut0g	Report: Facebook hatched 'emergency' plan using 'secret internal ranking' to suppress 'right-wing' news sources post-election	Other	Conservative
t3_k0nkxe	Cost of Lockdowns: A Preliminary Report	Other	Conservative
t3_k15453	Levin on Thanksgiving: No Thanks to Media, America Is a ‘Special Country’	Other	Conservative
t3_k153sj	“Father Knows Best's” 1954 Thanksgiving Prayer: 'We Thank Thee for the Privilege of Living as Free Men'	Other	Conservative
t3_k14e7q	Syrian Refugee Camps breeding Islamic terrorists	Other	Conservative
t3_k0yycj	Even If Mad About Election, Don’t Sit Out Georgia Runoffs	Other	Conservative
t3_k0vidp	Xi Focus: Xi stresses military training to raise capability of winning wars - Xinhua | English.news.cn	Other	Conservative
t3_k1634i	Twitter has suspended Pennsylvania State Senator Doug Mastriano after he lead the Senate Hearing today about election fraud	Other	Conservative
t3_k1ejjq	Please...	Other	Conservative
t3_k1l6u5	Gorsuch with the tactical nuke in his concurrence	Other	Conservative
t3_k1fwqo	Guess who’s not invited!	Other	Conservative
t3_k1ewqv	The sad life of those that are obsessed with Reddit groups that they hate	Other	Conservative
t3_k1e5dk	US Supreme Court Blocks Cuomo's NY Coronavirus Limits on Houses of Worship	Other	Conservative
t3_k1fdtx	This time they really are telling the truth... cOme oN gUys...	Other	Conservative
t3_k16zil	Calfiornia Governor Newsom Should Be Worried – The Petition To Recall Him Has Already Broken The Halfway Point At 750K Signatures	Other	Conservative
t3_k1gd4m	Report: “F” Grades Have Gone Up 83% Since Remote Learning Began	Other	Conservative
t3_k1fiuo	The nation’s highest court sided with the Roman Catholic Diocese of Brooklyn and Orthodox Jewish synagogues that sued the governor over the state-imposed caps in areas declared red and orange zones. “Even in a pandemic, the Constitution cannot be put away and forgotten."	Other	Conservative
t3_k1kd74	Twitter Blocks 'Potentially Harmful' Links to Sidney Powell Election Lawsuit	Other	Conservative
t3_k171id	Over 20K Votes Cast In GA From People Who Didn't Meet Residency Requirement	Other	Conservative
t3_k18z8n	Sydney Powell releases the 'Kraken'.	Other	Conservative
t3_k1d9nf	When Conservatives and Liberals were given the opportunity to fill out a moral Foundations questionnaire and told to predict how their ideological counterpart would respon, Conservatives were more accurate in their predictions than liberals, suggesting conservatives understand their opposition more.	Other	Conservative
t3_k1aarh	Supreme Court rules against Cuomo, blocks coronavirus restrictions on some New York houses of worship	Other	Conservative
t3_k16was	Sidney Powell E filing case in GA soon! 100 pages + Exhibits!	Other	Conservative
t3_k1l7hj	Happy thanksgiving California!	Other	Conservative
t3_k1iuc1	Suspect In San Francisco Area Fatal Stabbings Was Deported 3 Times, Not Turned Over To Authorities Due To Sanctuary Policy	Other	Conservative
t3_k17ctv	Kracken Released On Georgia! Attorney Sidney Powell Tweets Request For Info From Secretary Of State &amp; Announces Huge Law Suite Filing On Lou Dobbs	Other	Conservative
t3_k1fm8n	Morning Greatness: SCOTUS Smacks Down Cuomo’s Religious Restrictions	Other	Conservative
t3_k1hsel	Denver Mayor Jets Off to Houston After Telling People to Avoid Thanksgiving Travel	Other	Conservative
t3_k1brf2	Memory sticks used to program Philly’s voting machines were stolen from elections warehouse	Other	Conservative
t3_k1i48f	Sidney Powell’s Website Apparently Blocked by Twitter	Other	Conservative
t3_k1l88k	Thanksgiving: 51K Pounds of Roasted Turkey, Other Holiday Treats Flown to U.S. Warfighters Overseas	Other	Conservative
t3_k1nqrf	Apple is reportedly planning to move production out of China due to ongoing US-China trade war	Other	Conservative
t3_k1fb17	Food deemed non-essential as New Mexico governor shuts down grocery stores.	Other	Conservative
t3_k18gbh	India bans 43 more mobile apps as it takes on China	Other	Conservative
t3_k1g74n	Kraken Released: Sidney Powell Files Mother Of All Lawsuits In Georgia	Other	Conservative
t3_k1f73c	After 400 Years, The Top Reason People Come To America Is Still Freedom	Other	Conservative
t3_k168zo	Fighting Words - “Systemic racism” is an assertion made reflexively by Democrats that is never accompanied by evidence.	Other	Conservative
t3_k1d9cd	Sidney Powell Files Lawsuit in Georgia Alleging 'Massive Election Fraud'	Other	Conservative
t3_k1f50l	Supreme Court strikes down Cuomo's COVID restrictions on religious services in New York	Other	Conservative
t3_k1dqso	Gov. Mike Parson to Missourians: 'Government has no business' regulating gatherings in homes	Other	Conservative
t3_k16rj4	Study finds 84% fewer hospitalizations for patients treated with controversial drug hydroxychloroquine	Other	Conservative
t3_k1ig5v	Johns Hopkins: COVID Has Had No Effect On US Death Rate	Other	Conservative
t3_k15sns	Denver Mayor Flies to Family Thanksgiving, Said to 'Avoid Travel'	Other	Conservative
t3_k1ik0f	Kentucky Coffee Shop Defies Covid Orders As Line Of Supportive Customers Stretches Out The Door	Other	Conservative
t3_k17021	Facebook Suppressed Breitbart, Promoted CNN, Following Election	Other	Conservative
t3_k1f4kw	New Suit in Michigan Alleges ‘Dominion Computer Fraud’ and ‘Illegal Conduct’ by Election Workers	Other	Conservative
t3_k16a45	Pennsylvania state judge sides with GOP, halting election certification	Other	Conservative
t3_k1fiqq	Rep.-elect Lauren Boebert plans Thanksgiving 'funeral' for dead turkey in defiance of Colorado guidelines	Other	Conservative
t3_k1c673	Republican David Valadao Unseats Democrat T.J. Cox in California; Avenges 2018 Loss	Other	Conservative
t3_k1g5i3	Supreme Court Backs Religious Challenge To Cuomo’s Covid Restrictions; Barrett Delivers Decisive Vote	Other	Conservative
t3_k1a8ni	Governor Newsom Orders Police To Go Door To Door Arresting Anyone Not Depressed And Alone	Other	Conservative
t3_k16zbz	Kalkaska County board of commissioners approved resolution calling for Gov. Whitmer's impeachment	Other	Conservative
t3_k1pnkw	Alex Trebek Left a Thanksgiving Message for America: “Keep the faith, we’re going to get through all of this, and we will be a better society because of it.”	Other	Conservative
t3_k1q44y	Recently Pardoned Turkey Found Dead After Claiming To Have Dirt On Hillary Clinton	Other	Conservative
t3_k1fkqv	Report: Dead People Voted in Close New York Congressional Race	Other	Conservative
t3_k15ynt	After warnings to avoid travel, Denver Mayor Hancock flies to visit family for Thanksgiving	Other	Conservative
t3_k1jhax	Twitter Suspends Col. Doug Mastriano After He Leads PA Hearing on Election Fraud	Other	Conservative
t3_k19o6s	Sidney Powell group’s Michigan affidavit also just released.	Other	Conservative
t3_k1frb0	New Suit in Michigan Alleges ‘Dominion Computer Fraud’ and ‘Illegal Conduct’ by Election Workers	Other	Conservative
t3_k18mlk	Lin Wood: ‘11th Circuit granted my Emergency Motion for Expedited Review of lawsuit challenging validity of GA election procedure’	Other	Conservative
t3_k1fwcc	What happened to the olive branch? Alyssa Milano calls Michael Flynn (and others) an 'a**hole'	Other	Conservative
t3_k1cypk	Supreme Court temporarily bars New York from setting church attendance limits	Other	Conservative
t3_k1gg12	Supreme Court rules against Cuomo's coronavirus limits -- with Barrett playing key role	Other	Conservative
t3_k1fexf	Give Thanks…	Other	Conservative
t3_k18zai	Defending the Republic – Sidney Powell's Legal Defense Fund	Other	Conservative
t3_k1j334	Vermont Governor Goes Full Leftist Dictator: Schools Will Question Students About Thanksgiving, Boot Those Who Gathered	Other	Conservative
t3_k1bdy9	Subpoena in Georgia Election Lawsuit Seeks Video Footage From Voting Site	Other	Conservative
t3_k1asrp	BREAKING: Sidney Powell Releases The KRAKEN On Michigan and Georgia!	Other	Conservative
t3_k17seo	Andrew McCarthy: Gen. Flynn Should Not Have Needed a Pardon -- "Plainly, the interview was a perjury trap."	Other	Conservative
t3_k1lgg1	Nancy Pelosi condemns Michael Flynn Pardon: "An act of grave corruption and a brazen abuse of power."	Other	Conservative
t3_k1lal0	GOP Poll Watcher and Fraud Expert Gives Explosive Testimony About What He Observed Happen in Delaware County, PA: "In all cases the chain of custody was broken... in all cases they didn't follow any of the procedures defined by the Board of Delaware County of Elections."	Other	Conservative
t3_k1hrrj	New book meticulously debunks NYT’s 1619 Project–plus offers positive, accurate narrative of America’s past	Other	Conservative
t3_k1g0vm	School Votes to Remove a Rock Because It Was Called a Racist Name Nearly a Century Ago	Other	Conservative
t3_k1ei8p	What lockdown? New congresswoman Lauren Boebert of Colorado is holding Thanksgiving 'funeral' for turkey. Solves the issue of limiting Thanksgiving gatherings to 10 people while allowing 30 at funerals.	Other	Conservative
t3_k1dk98	Supreme Court Blocks Covid Restrictions on Religious Services in NY	Other	Conservative
t3_k18ftk	Obama used signature process to disqualify opponents	Other	Conservative
t3_k1mys7	Update to Michigan Affidavit. Some precincts reporting 780, 400 percent turnout	Other	Conservative
t3_k1fjic	DUMB AND DUMBER': How Cuomo And De Blasio Ruined New York	Other	Conservative
t3_k1es8y	Sidney Powell released the Kraken in Georgia	Other	Conservative
t3_k1c2nl	Michigan Gov. Gretchen Whitmer Nominated for Time 'Person of the Year'	Other	Conservative
t3_k1nrmw	Florida Governor Extends Ban On Local Enforcement Of Mask Mandates, Business Restrictions	Other	Conservative
t3_k1h672	Thousands in Georgia use fake addresses on registration	Other	Conservative
t3_k1bpvv	Sidney Powell's Georgia Complaint	Other	Conservative
t3_k1697w	Mysterious Orange-Haired Vigilante Smuggles Thousands Of Beer Kegs Into Prohibition-Era Pennsylvania	Other	Conservative
t3_k1o0sj	Rush Limbaugh Just Gave A Thanksgiving Goodbye – Rush Says His Listeners Gave Him “One Of The Greatest Lives”	Other	Conservative
t3_k1hp9a	Americans Should Be Free to Decide How to Celebrate Thanksgiving	Other	Conservative
t3_k1pm5l	Witness Testifies at Pennsylvania Election Hearing: Voting Machines 'Built to Be Manipulated'	Other	Conservative
t3_k16pzu	Denver mayor warns against holiday travel, then hops on a plane to visit family for Thanksgiving	Other	Conservative
t3_k1ncp8	Sidney Powell Files New Michigan Lawsuit	Other	Conservative
t3_k19owq	Appeals Court Grants Expedited Review Over Lin Wood's Lawsuit Challenging Georgia Election Procedures	Other	Conservative
t3_k18j28	2 NYPD officers shot in Queens, suspect dead	Other	Conservative
t3_k17cew	Doctors Without Borders: Socialists Are Blocking Our Specialists from Entering Venezuela	Other	Conservative
t3_k1kd38	Powell Lawsuit in Michigan Alleges 'Dominion Computer Fraud' and 'Illegal Conduct' by Election Workers	Other	Conservative
t3_k1k7q4	Sidney Powell Files Lawsuit in Georgia Alleging 'Massive Election Fraud'	Other	Conservative
t3_k1c5gx	Appeals Court Grants Expedited Review Over Lin Wood's Election Lawsuit in Georgia	Other	Conservative
t3_k1a8ko	Here is a link to the Michigan affidavits - [Exhibit Exhibit 1 – #1, Att. #1 in King v. Whitmer (E.D. Mich., 2:20-cv-13134) – CourtListener.com]	Other	Conservative
t3_k1kkww	Staffers Crying Over Jordan Peterson Book Cured By Forcing Them To Read Jordan Peterson Book	Other	Conservative
t3_k1ijou	Denver’s Democrat Mayor Blasted Over His Response To Violating His Own Coronavirus Recommendations	Other	Conservative
t3_k1hgkp	Lawsuit Sidney Powell Filed in Georgia	Other	Conservative
t3_k1776p	Banned Catholic pro-life midwifery student wins apology and payout	Other	Conservative
t3_k1njtt	Gov. Cuomo calls SCOTUS ruling on gatherings ‘irrelevant’	Other	Conservative
t3_k18e07	Pa. AG Rejects Fraud Hearing as 'Fake,' 'Devoid of Reality'	Other	Conservative
t3_k18lvb	Michigan county clerk fights for election integrity	Other	Conservative
t3_k1azzh	Redacted affidavit for China / Iran Interference [.PDF]	Other	Conservative
t3_k1q8ib	Sidney Powell Suit Makes 30 Allegations in Bid to Invalidate Georgia Election Results	Other	Conservative
t3_k1px41	Cuomo calls Supreme Court church ruling ‘irrelevant’ despite decision	Other	Conservative
t3_k1hvzx	Seattle mayor to cut police department budget 18% after City Council approval	Other	Conservative
t3_k18u2a	Sanctuary Outrage: Criminal alien arrested in two murders after California released him repeatedly	Other	Conservative
t3_k187l1	San Antonio Mayor Ron Nirenberg Issues 10 pm City Curfew for Thanksgiving Night, Barely Giving Local Residents a 24 Hour Notice	Other	Conservative
t3_k18an7	(And So It Begins) - Pa. Slams Judge's 'Overreach' in Delaying Vote Certification	Other	Conservative
t3_k1f7t3	Fight against electoral fraud is a fight against totalitarianism	Other	Conservative
t3_k1cglv	BREAKING: Sidney Powell Releases the 'Kraken' in Georgia with Explosive New Lawsuit	Other	Conservative
t3_k1hmeb	Thanksgiving: On Being Grateful for Our Gifts and Blessings	Other	Conservative
t3_k1dqio	Judge rules California can't deny man wanting 'QUEER' on his license plate	Other	Conservative
t3_k1pm0i	PCR-Based Covid Testing Has Failed- "A false positive pseudo-epidemic is a well described phenomenon in the medical literature which results in an exponential rise in diagnosed cases and deaths but no excess deaths."	Other	Conservative
t3_k1mt8s	Poll Watcher Describes Pennsylvania Election Irregularities, Including 47 Missing USB Cards	Other	Conservative
t3_k16pm0	Days before Christmas, Jupiter and Saturn will look like one bright star — some believe the alignment is the same described in the Bible	Other	Conservative
t3_k1qvsv	Multiple Oregon elected officials face backlash for tropical vacations during COVID-19 surge	Other	Conservative
t3_k1d22a	Legal Group Files Lawsuit Challenging Over 200,000 Ballots in Georgia	Other	Conservative
t3_k1c3p3	Affidavit for electronic interference in Dominion Voting Systems	Other	Conservative
t3_k1f85l	Senseless Restrictions on Outdoor Activities Undermine the Goal of Curbing COVID-19	Other	Conservative
t3_k187ir	Dr. Barbara Ferrer got her PhD in social welfare from Brandeis and she has banned outdoor dining because it spreads covid in LA County. She isn't a doctor or have a background in biology/med school	Other	Conservative
t3_k1pxc0	Listen: Rush Limbaugh on the ‘True Story of Thanksgiving’ — ‘Long Before Karl Marx’ the Pilgrims Experimented with Socialism -- It didn't work.	Other	Conservative
t3_k1mnc5	Mattis failed to disclose role with global consultant tied to China in bombshell column	Other	Conservative
t3_k18mtm	Wait...A Judge Halts PA From Taking Further Steps in Certifying Its Election Results?	Other	Conservative
t3_k1f4vw	Lives And Livelihoods Will Be Destroyed While Dems Wait Until 2021 For The Vaccine And Stimulus	Other	Conservative
t3_k19ohf	George Washington: Thanksgiving Proclamation, 3 October 1789	Other	Conservative
t3_k18ipz	Lucky Joe gets phone call from China President Xi Jinping	Other	Conservative
t3_k1qs4y	Amistad Project Files Litigation Calling More Than 150,000 Wisconsin Ballots into Question	Other	Conservative
t3_k1hqam	Roman Catholic Diocese of Brooklyn Reacts to SCOTUS Ruling on Religious Freedom	Other	Conservative
t3_k186nr	Antifa Burns Nazi Manifesto's Section On Racism, Preserves Remainder As Part Of Own Platform	Other	Conservative
t3_k15twi	Bexar County judge, San Antonio mayor issue nightly curfew for Thanksgiving weekend	Other	Conservative
t3_k1qici	Complaint filed by Powell and L. Lin Wood in Michigan (Eastern District Court), Quotes from Whistleblower who Witnessed Chavez, Smartmatic Conspire	Other	Conservative
t3_k16jyd	Schiff, Nadler Call Flynn Pardon 'Abuse of Power'	Other	Conservative
t3_k1ht24	California AG's Brief Claims "Hate Speech" Is Constitutionally Unprotected	Other	Conservative
t3_k1gx4f	Mum's appointments cancelled due to Covid is told of cancer over ZOOM	Other	Conservative
t3_k1es20	Thanksgiving: Mayflower Compact Foundation of American Liberty	Other	Conservative
t3_k1f5ts	The Smartmatic Story: From Venezuela With No Love	Other	Conservative
t3_k1cna2	Denver mayor flying to Houston despite warning not to travel	Other	Conservative
t3_k19702	Be Grateful for Capitalism This Thanksgiving	Other	Conservative
t3_k16sb6	Firestorm on Twitter in Spain after trending topic calls for burning priests	Other	Conservative
t3_k1ogsc	Witness Testifies at Pennsylvania Election Hearing: Voting Machines 'Built to Be Manipulated'	Other	Conservative
t3_k1blcl	Small Social Gatherings and Dinners Aren’t Driving the Virus	Other	Conservative
t3_k1r4mc	‘Orwellian’: Parler CEO Eviscerates Facebook’s ‘Secret Internal Algorithm’	Other	Conservative
t3_k1k1u0	Supreme Court rules against Cuomo&amp;amp;apos;s coronavirus limits -- with Barrett playing key role	Other	Conservative
t3_k1agch	Feels like there are 2 separate realities	Other	Conservative
t3_k15ylk	The picture of U.S economy is worrisome, economists cry out	Other	Conservative
t3_k15poj	Conservatives only Discord Server	Other	Conservative
t3_k1f4lb	Giving Thanks in America	Other	Conservative
t3_k18g77	Pennsylvania Slams Judge’s ‘Overreach’ in Certification Ruling	Other	Conservative
t3_k1r36e	BBQ Rebellion: Restaurant Owner Arrested After Days of Defying Toronto Lockdown	Other	Conservative
t3_k1q5sy	China: State media step up campaign to muddy probe into Covid origin	Other	Conservative
t3_k1pxwe	UK: Number of children referred to social services for gang exploitation continues to rise	Other	Conservative
t3_k165xx	NYC sheriffs expanding COVID checkpoints for out-of-state visitors ahead of Thanksgiving	Other	Conservative
t3_k1ozi3	x Pentagon Purges Leading Advisors From Defense Policy Board	Other	Conservative
t3_k1d8rg	Watch Lou Dobbs Berate Young FOX News Hack on Live TV After He Minimized and Mocked GOP Hearing in Pennsylvania	Other	Conservative
t3_k18va7	Covid vaccination to get essential for international travellers | Flash News	Other	Conservative
t3_k18hh8	Wall Street banks slam lending proposal as ‘unworkable’ and ‘political’	Other	Conservative
t3_k1gity	Calvin Coolidge on the importance of Thanksgiving	Other	Conservative
t3_k1pyfz	Spain’s Government Declares War on the Spanish Language	Other	Conservative
t3_k1pvhx	Charles Koch: 'Horrified' When Donations Didn't Buy Politicians' Votes On Immigration And Other Issues	Other	Conservative
t3_k1f6is	The Intimidation and Unfair Enforcement of Detroit’s Election	Other	Conservative
t3_k1jp56	US Senator calls for better threat identification technologies | Flash News	Other	Conservative
t3_k1f5i8	Five books Penguin will have to ban along with Jordan Peterson	Other	Conservative
t3_k167hw	ATF Goes Rogue on Gun Owners	Other	Conservative
t3_k1pzv2	The Pilgrims Tried Collectivism and Failed	Other	Conservative
t3_k1ne5p	Group breaks windows, tags SE Portland businesses with graffiti	Other	Conservative
t3_k1i2w6	Mike Rowe reveals he’s ‘thankful to be living in America during the most remarkable year of my life’	Other	Conservative
t3_k15y0r	WSJ Editorial Board: A Pardon for General Flynn	Other	Conservative
t3_k1o8u9	France bans citizens from filming and identifying violent police officers	Other	Conservative
t3_k1f950	400 Years Later, I Made New Discoveries About The First Thanksgiving	Other	Conservative
t3_k16wkk	Report: Moscow Plans Social Credit System	Other	Conservative
t3_k16uzv	Petition to remove Big Papa T.	Other	Conservative
t3_k15zfa	James Freeman: Thanksgiving and the American Character	Other	Conservative
t3_k1efm4	Belfast Telegraph journalist warned of threat against them by loyalist paramilitaries	Other	Conservative
t3_k1jwsb	America's Lost Landmarks: Famous Historic Buildings And Landmarks That No Longer Exist	Other	Conservative
t3_k1de1o	University of Maryland’s School of Public Policy has decreed that faculty must participate in corporate confessions of sin to the previous inhabitants of the taxpayer-funded institution’s geography. Forces Professors to acknowledge they are on "stolen land".	Other	Conservative
t3_k196aa	Report Pennsylvania's Governor Wolf To The FTC Immediately	Other	Conservative
t3_k18mt6	Jon Ossoff Ignores Sen. Perdue's Clear Vindication From Claims of Insider Trading	Other	Conservative
t3_k16qvq	Priest calls police on mother of 11 praying in empty church without a mask	Other	Conservative
t3_k1o35i	BBC news output receives lowest impartiality score of any British broadcaster, new survey finds	Other	Conservative
t3_k1hlj3	A closer look at U.S. deaths due to COVID-19	Other	Conservative
t3_k1f7xm	No, The Pilgrims Didn’t Desecrate Native American Graves, And Other Myths You Shouldn’t Believe	Other	Conservative
t3_k1emib	Obama: It’s Impossible to Have a Democracy if People Disagree With You	Other	Conservative
t3_k1d6vs	New York Times takes aim at Thanksgiving, and indoctrinating kids. Now publishing teaching guides to ensure our kids truly understand how horrible their country is.	Other	Conservative
t3_k19lph	Flashback to 5 days ago	Other	Conservative
t3_k17pfg	Have a Historically Accurate Thanksgiving!	Other	Conservative
t3_k16qac	Police say juvenile who allegedly wrote racist messages against Black Lives Matter at a grade school playground committed a misdemeanor violation	Other	Conservative
t3_k16oe3	How Very Stasi: COVID-19 Restrictions Go Full Authoritarian	Other	Conservative
t3_k15yw1	Kim Strassel: Justice for General Flynn	Other	Conservative
t3_k1q8mb	Chinese Beidou Navigation System Has exceeded American GPS In Over 165 Countries around the Globe | Flash News	Other	Conservative
t3_k1p0m5	The Difficult Way Forward	Other	Conservative
t3_k1o90i	Cuomo: State readies 'winter plan' for COVID; SCOTUS ruling 'irrelevant'	Other	Conservative
t3_k1ln1d	SCOTUS Church Ruling 'Major Step' for Ban Challenges	Other	Conservative
t3_k1enqf	Nine useful articles and data points showcasing 2020's election theft	Other	Conservative
t3_k1drcv	I'm for the Constitution': Meet the NY sheriff standing up to Andrew Cuomo this Thanksgiving	Other	Conservative
t3_k1cgwx	A Progressive Assault on Selective High Schools. Instead of fixing public education, the left tries to end testing at schools it deems inequitable.	Other	Conservative
t3_k18yo2	Open letter to patriots everywhere -- LIVE FREE!	Other	Conservative
t3_k1haod	Data Group Exposes Widespread Mail-In Ballot Fraud	Other	Conservative
t3_k19gi2	PA Senate Held Election Fraud Hearing Today: Updates on Voter Fraud Allegations	Other	Conservative
t3_k18icl	America’s still failing to protect Christians across the Middle East	Other	Conservative
t3_k1lyyr	Vladimir Putin allegedly has a secret lovechild with cleaner now worth $100M	Other	Conservative
t3_k1drmz	Glenn Beck: Here's what these Democrats should be thankful for this Thanksgiving	Other	Conservative
t3_k16ygk	America’s Critical Point in Time: The decades-long communist assault on America is reaching a climax	Other	Conservative
t3_jzta4e	Trump Administration To Start Transition Process For Biden	T	Conservative
t3_jzfqzc	Do Trump-Supporters Live in an Alternate Universe? Actually a huge number of Americans have a false impression of reality because they are being told lies by their media. The people who constantly hear these lies do live in an "alternate reality."	TS	Conservative
t3_jzqpbm	Rush Limbaugh criticizes Trump legal team for promising 'bombshells' and failing to deliver	TS	Conservative
t3_jzms1q	Pro-Trump Attorney Lin Wood Urges Republicans Not To Vote In Georgia Senate Runoff -- Unless GOP candidates help overturn the presidential election results in the state.	EF	Conservative
t3_jzti5c	GSA Sends Letter to Biden Making Resources Available for Transition	T	Conservative
t3_jz9dqx	Lou Dobbs Warns the GOP: Republican Party ‘Will Be Gone and Done’ If They Don’t Stand With President Trump	TS	Conservative
t3_jzlwxs	Bombshell: Biden takes min 98% of a 23,487 vote batch at 12:18AM in GA	ER	Conservative
t3_jzjbne	Sidney Powell Confirms Non-Affiliation With Trump Legal Team, Vows to Continue Fraud Fight	EF	Conservative
t3_jzk9j0	Sidney Powell Responds to Trump Campaign's Statement Saying She's Not Part of Legal Team -- Powell said her fight will go on anyway and closed her statement with the hashtag, "#KrakenOnSteroids"	TS	Conservative
t3_jzjzln	A Neighbor You Like Probably Voted For Trump	ER	Conservative
t3_jzitza	Why The Left Can Be So Ridiculously Self-Righteous Without Realizing It -- What we saw in the lead up to the elections, and what we’ll witness for years to come, is utter contempt for Trump voters and conservatives in general.	TS	Conservative
t3_jzjptq	Two-thirds of GOP voters support Trump running for president in 2024: survey	O	Conservative
t3_jznypc	Trump campaign takes Pennsylvania election fight to federal appeals court	EF	Conservative
t3_jzjlmh	Democrat House Losses Stemmed From Trump Increasing Voter Turnout: Rep. Richmond	ER	Conservative
t3_jzbqm7	Trump campaign demands recount, signature matching in Georgia	EF	Conservative
t3_jzpd7w	JUST IN: Third Circuit Court of Appeals Grants Expedited Review For Team Trump’s Appeal in Pennsylvania	EF	Conservative
t3_jzi0vw	5 More Ways Joe Biden Magically Outperformed Election Norms	ER	Conservative
t3_jzloh0	Watergate journalist Carl Bernstein outs 21 Republican senators who 'privately' expressed 'extreme contempt' for Trump.	TS	Conservative
t3_jzijpr	Trump Pulls Out Of Military Transparency Treaty With Russia, Europe	TP	Conservative
t3_jzu0rh	Rush Limbaugh On Trump’s Legal Team: ‘They Promised Blockbuster Stuff And Then Nothing Happened’	TS	Conservative
t3_jzqca2	Trump scores two wins as Michigan legislature, federal appeals court agree to election reviews	EF	Conservative
t3_jznr0d	Appeals Court Grants Expedited Review of Trump Campaign's Pennsylvania Lawsuit	EF	Conservative
t3_jzua12	GSA notifies Joe Biden that Trump administration is ready to start transition process	T	Conservative
t3_jzn4sl	Biden proposes John Poulos, CEO and President of Dominion Voting Systems, as Surgeon General and Head of Covid Analytics. Dominion will now be solely in charge of recording and keeping an exact count of what has become the most deadly virus in the history of the world.	BP	Conservative
t3_jzi8g6	Trump’s legal team’s statement on Sydney Powell was made to focus on the upcoming Supreme Court case. There are two separate legal pathways. One on equal protection and PA voting rules (most important right now). The second is Dominion software which will take longer.	TP	Conservative
t3_jzu8wb	Trump accepts transition to Biden can begin	T	Conservative
t3_jzo4tp	Journalist Carl Bernstein names 21 GOP senators who 'privately expressed their disdain' for Trump	TS	Conservative
t3_jzmj9c	Political Enemy List Trump Accountability Project Publicly Posted on Their Website	TS	Conservative
t3_jzpdpe	Trump's election lawsuit leads to 3rd Circuit grant for expedited review	EF	Conservative
t3_jzjgop	Open Letter Calls on Harvard to Create 'System of Accountability' for Inviting Trump Admin Alums to Campus	TS	Conservative
t3_jzpzzc	Janet Yellen Is Biden’s Pick for Treasury Secretary	BP	Conservative
t3_jzl6re	5 More Ways Joe Biden Magically Outperformed Election Norms	ER	Conservative
t3_jzntsc	GOP Former National Security Officials Urge Party to Demand Trump Concession	EF	Conservative
t3_jzkul5	Trump: More Votes Than Voters in Key Swing States	EF	Conservative
t3_jzq15s	Rush Limbaugh: Trump Needs to Hold Rallies in Georgia	TP	Conservative
t3_jzmy0e	Joe Biden is a very weak President, could start wars': Chinese government advisor | World News - Times of India	BS	Conservative
t3_jzhelc	Mike Flynn Jr. adds twist to Trump team’s statement on Sidney Powell: ‘Give this the 24hr rule …’	TS	Conservative
t3_jzud9p	Bernstein names 21 Republican senators who privately expressed contempt for Trump	TS	Conservative
t3_jzrhs0	Biden's Treasury Secretary: Janet Yellen	BP	Conservative
t3_jzkxnl	Professor causes uproar asking Biden voters to unfriend him	BS	Conservative
t3_jzmvum	Appeals Court Grants Expedited Review of Trump Campaign's Pennsylvania Lawsuit	EF	Conservative
t3_jzaqqe	An statement from Senator Toomey regarding the Pennyslvania Federal Court decision regarding the Trump campaign lawsuit.	EF	Conservative
t3_jzqyu6	Joel Kotkin: The Green End Game Runs Through Biden	BP	Conservative
t3_jzo3u5	Obama's third term: Biden reveals first cabinet picks	BS	Conservative
t3_jzaje9	Scranton dedicates 'Joe Biden Way' to honor president-elect	O	Conservative
t3_jzq2wb	Sidney Powell responds to Trump Campaign legal statement with agreement but an “epic” lawsuit is still coming this week	TS	Conservative
t3_jzhbcz	The Death Star Strategy: Is Trump Contemplating The Ultimate Constitutional Trick Shot?	TS	Conservative
t3_jzu0lg	Walter Mead: Biden’s Foreign-Policy Team Takes Shape	BP	Conservative
t3_jznsl5	Biden secretary of state pick Blinken criticized over Iraq War, consulting work	BS	Conservative
t3_jzexf7	Trump’s gains in North Philly show Latino voters are not a ‘gimme’ for Democrats	ER	Conservative
t3_jzu5h2	The Socio-Political Legacy 0f Trump	TS	Conservative
t3_jznbrr	U.S. Election: Trump legal team distances itself from lawyer after controversial comments - National | Globalnews.ca	TS	Conservative
t3_jzsxow	Trump Lawyer: Michigan Legislature Agrees to Hold Election Review Hearings	EF	Conservative
t3_jzrh4s	Hours After Biden Picks Blinken For Secretary Of State – His Closet Door Swings Open On Iraq And Consulting	BS	Conservative
t3_jzrc5e	Rep. Nunes Worried Biden Will Shut Down Durham Investigation	BS	Conservative
t3_jzdaid	Report: Maryland Gov. Larry Hogan, Anti-Trump Hero, Paid for Flawed Coronavirus Tests from South Korea	TS	Conservative
t3_jzcm4f	Report: Biden to Name Russia Hoaxer, CNN Analyst Tony Blinken Secretary of State	BP	Conservative
t3_jz8xh4	Trump campaign to appeal dismissal of election lawsuit in Pennsylvania	EF	Conservative
t3_jzlu2s	All Republicans should support President Trump's legal fights -- Any who believe that buddying up to the Biden team is a symbol of unity, and better for America, have already abandoned Trump, conservatism, and America.	TS	Conservative
t3_jzk5a1	A Circuit Breaker on Election Night? (...nearly 30 percent of Democrat voters think the election was stolen from Trump)	EF	Conservative
t3_jzieod	GOP Can't Let Trump-Hating Squishes Take Over the Party Now	TS	Conservative
t3_jzjii3	Mark Levin: Letting Trump's legal efforts play out far better than 'what the Democrats are doing to our institutions'	BS	Conservative
t3_jztzoa	The mullah report: is Biden bringing back the Iran Deal? | Spectator USA	BP	Conservative
t3_jzt2hb	Data: Trump's Anti-Globalism, Pro-Police Message Wins Over Hispanics	TP	Conservative
t3_jzsh0c	Trump Lawyer: Michigan Legislature Agrees to Hold Election Review Hearings	EF	Conservative
t3_jzl08r	Biden's Surge In Polls Motivated By Fear	O	Conservative
t3_jzkyjm	NY Mag Scientifically Proves Biden Supporters Are Racist	BS	Conservative
t3_jztwv2	Revolving Door: Obama Staffers Who Joined NBC, MSNBC, and CNN, Now Headed to Biden Admin	BS	Conservative
t3_jzrsl7	DuPont’s Shaped Biden’s "Views" (no experience!) on Business	BS	Conservative
t3_jzrfhk	Biden &amp; Corporate Charters: A Radical, Regressive Proposal	BS	Conservative
t3_jzqrab	Poll: Americans Want Biden to Stay Out of Trump Investigations &amp; Pass on Progressive Policies for Now	TS	Conservative
t3_jzkwq8	Study: Biden won thousands of illegal votes by noncitizens	EF	Conservative
t3_jzbe4j	Orwell's 1984 is prophetic: How the leftists are trying to change and erase President Trump and history	O	Conservative
t3_jz90wi	Obamas Collaborating on Anti-Trump Netflix Serie	O	Conservative
t3_jzhhqb	Once an election has been shown dirty, all voters have been disenfranchised- "Joe Biden won illegal votes from thousands of noncitizens, study shows"	EF	Conservative
t3_jzt98m	Appeals Court Grants Expedited Review of Trump Campaign's Pennsylvania Lawsuit	EF	Conservative
t3_jzrtvc	N.Y. Times op-ed admits: Trump was correct, reopen the schools	TP	Conservative
t3_jzicud	Here Comes the Biden Blame Game - If the double-dip recession hits next year, Biden will remind us over and over that it’s Donald Trump’s fault. He’ll be wrong.	BS	Conservative
t3_jz995u	President Trump in virtual G-20 remarks: "The Paris Accord was not designed to save the environment -- it was designed to kill the American economy."	TP	Conservative
t3_jzt6dy	Appeals court to review Trump's Pennsylvania case -- Legal team on track with plan to reach Supreme Court	EF	Conservative
t3_jz8s6s	Mail in ballots come in envelopes. They have creases. "Ga Poll Worker Describes Pristine Mail In Ballots, 98% for Biden"	EF	Conservative
t3_jzth0n	Seven Letter Poll: 79 Percent of Trump Voters Say Election 'Stolen'	EF	Conservative
t3_jzsv52	Hunter Biden Arrives At White House Dressed As Turkey In Hopes Of Being Pardoned By Trump	BS	Conservative
t3_k080zd	FBI Buried Hunter Biden Laptop: It’s unlikely there was ever any investigation at all.	BS	Conservative
t3_k0ao2g	Biden’s win in Nevada certified by Nevada Supreme Court	ER	Conservative
t3_k02wgo	Maxine Waters Pushes for Investigation of 'Criminal' Trump To 'Send a Message Across the World'	TS	Conservative
t3_jzx2jg	James Mattis: Joe Biden Must 'Eliminate "America First"' from U.S. Foreign Policy	O	Conservative
t3_k0ddev	Nolte: Only 3% of Trump Voters Believe Joe Biden Is Legitimate Winner	EF	Conservative
t3_k05eu0	Trump lawsuit confuses Michigan and Minnesota locations in affidavit claiming voter fraud	EF	Conservative
t3_k08cy8	Trump campaign continues to fight as more evidence of voter fraud emerges	EF	Conservative
t3_k056dg	John Brennan's breathless &amp;amp; dramatic thread bidding farewell to the president is met with calls for Trump to 'declassify everything'	O	Conservative
t3_jzzay5	Trump Won't Budge From Veto Threat Over Renaming Bases Honoring Confederates	TS	Conservative
t3_jzuvjc	Trump Administration Begins Transition Process	T	Conservative
t3_k084zn	FNC's Laura Ingraham: 'I Would Be Lying to You' if I Said There Was an 'Excellent' Chance SCOTUS Delivers Victory to Trump	EF	Conservative
t3_k0b0kz	Trump vows he’ll ‘never concede’ despite administration starting transition move	T	Conservative
t3_k0cbf4	Rashida Tlaib accused of anti-Semitism for reaction to Biden's Jewish Sec of State nominee	O	Conservative
t3_k0eyot	Joseph Nye: "Trump deserves credit for pushing back on China's abusive trade practices, but it would have been better if we worked with our allies to isolate China. Also, his trade deal has been costly for Americans without changing the trade imbalance or addressing technological issues."	TP	Conservative
t3_k0dlm3	Pennsylvania, Nevada certify election results for Biden despite Trump legal challenges	ER	Conservative
t3_k082id	Biden's Pick For National Security Adviser Is A Steele Dossier Truther	BP	Conservative
t3_k0eqm4	After joining Burisma, Hunter Biden requested meetings with Antony Blinken, Biden's Pick for Secretary of State	BP	Conservative
t3_k0ex0g	Dominion Executive: Trump is not going to win. I made f***ing sure of that.	TS	Conservative
t3_k0cb1h	Hawley 2024? Missouri Republican could be ‘Trump 2.0,’ say conservative supporters	O	Conservative
t3_jzvs4f	Trump Tells GSA, and His Team, to Begin the Transition Process; Vows to ‘Keep Up the Good Fight’	T	Conservative
t3_k085p9	Rubio derides Biden's foreign policy team: 'Polite and orderly caretakers of America's decline'	BS	Conservative
t3_k0f9nk	Where are the Republican Politicians? Have they Deserted Trump?	TS	Conservative
t3_k0dwph	Mattis says he hopes Joe Biden takes 'America First' out of national security strategy	BP	Conservative
t3_k0c7j8	Chris Evans, Zach Braff Want A List Of ‘Trump Enablers’	TS	Conservative
t3_k0elxb	The Fourth Estate: Andrea Mitchell reports that a Biden administration isn't going to be political	BS	Conservative
t3_k0fcyi	Poll: One In Six Biden Voters Would Have Changed Their Vote If They Had Known About Scandals Suppressed By Media	BS	Conservative
t3_k0flpb	Hunter Biden Arrives At White House Dressed As Turkey In Hopes Of Being Pardoned By Trump	BS	Conservative
t3_k0ei4s	Dan Bongino hints at potential run for president in 2024 if Larry Hogan runs and no Trump does	O	Conservative
t3_jzw2s8	Trump Tells GSA, and His Team, to Begin the Transition Process; Vows to ‘Keep Up the Good Fight’	T	Conservative
t3_k0flhj	Biden’s Gun-Registration Scheme Would Cost Firearm Owners Billions — If It Passed Congress and Americans Complied	BP	Conservative
t3_k0flki	Mueller Probe's Andrew Weissmann Wants Biden DOJ to Prosecute Trump	TS	Conservative
t3_k0gw1d	Holman Jenkins: Media Hysteria Is the Trump Show	TS	Conservative
t3_k0gu0e	Biden’s Cabinet: The Return of the Blob	BP	Conservative
t3_k0fhm7	The Biden Popular Front Is Doomed to Unravel	BS	Conservative
t3_k0cwtc	Google Plots to Use the Biden Administration to Avoid Accountability	BS	Conservative
t3_k0e8yx	Poll Shows Media Censorship Cheated Voters of Vital Info, Robbed Trump of Second Term	EF	Conservative
t3_k0ccte	Trump: Voters are '100% correct' that 2020 'election was stolen' -- Jenna Ellis: 'Media chatter of Joe Biden picking his cabinet is like fantasy football'	BS	Conservative
t3_k089yi	Malevolent travelers' coming if Trump's travel ban killed -- Biden has promised to eliminate executive order on 'Day 1'	TS	Conservative
t3_k0gusb	EXPLOSIVE Study: Media Suppression of 8 Key Stories 'Stole This Election' for Joe Biden	BS	Conservative
t3_k0azmb	Computer Repair Shop Involved in Hunter Biden Laptop Scandal Shuttered	BS	Conservative
t3_k07tg5	Sidney Powell responds after Trump campaign says she is not part of legal team: '#KrakenOnSteroids'	TS	Conservative
t3_k06ko7	Biden’s Student Loan Bailouts: Bad Economics, A Regressive Tax, And A Moral Hazard	BP	Conservative
t3_k07qob	Patrick Buchanan: "What Trump Will Leave in Biden's Inbox"	T	Conservative
t3_k06k0b	Two of Joe Biden's national security picks have ties to past scandals	BS	Conservative
t3_k05c36	War and more war coming with Biden’s Sec. of State Blinken	BP	Conservative
t3_k0bxsq	From revolution to restoration: Biden picks Blinken, Yellen, Kerry for plum posts	BP	Conservative
t3_k06hmi	Graham warns Biden, Pelosi and Schumer would form 'trifecta from hell' if Democrats take Senate	O	Conservative
t3_jzvyov	Perdue, Loeffler Join Trump Call for New Georgia Recount	EF	Conservative
t3_k0gldq	President Trump won?	ER	Conservative
t3_k0e90v	Secretary of state pick Antony Blinken met twice with Hunter Biden	BS	Conservative
t3_k087mh	In picking John Kerry as his cabinet-level “climate czar,” Joe Biden is signaling strong support for Rep. Alexandria Ocasio-Cortez’s costly Green New Deal. Rumors are circulating that AOC is being considered for EPA administrator or elsewhere in the administration.	BP	Conservative
t3_k0bp1y	Election Aftermath: Either Or -- It is down to an “either or” situation: either President Trump prevails in his lawsuits and multiple constitutional paths to reelection, or Joe Biden and the Democrats succeed in stealing the election.	EF	Conservative
t3_k04poa	Fearing break-up, Facebook plans to woo Joe Biden with new vaccine and climate change PR	O	Conservative
t3_k01ja2	Alan Dershowitz Says Trump Still Has ‘Two or Three Constitutional Paths’ To A 2020 Victory – But He Hasn’t Seen The Evidence To Overturn	EF	Conservative
t3_k0dv2v	WJ Live': The Viral Memo Changing the Trump Legal Strategy	TP	Conservative
t3_k0ah7t	Ted Cruz Hits AOC for Criticizing Senate Recess. "AOC seems not to know there are Democrats in the Senate. Or that Joe Biden (also a Dem) is publicly calling on Senate Dems to continue filibustering COVID relief because he thinks it will help them win Georgia.”	ER	Conservative
t3_k06f5y	2020 has been miserable in so many ways. Well here's an uplifting story guaranteed to make you smile and feel better. It's a heartwarming story of two deceased voters who made their voices heard for biden.	EF	Conservative
t3_jzyv4s	Jenna Ellis insulted Trump and his supporters in 2016. The RINOs are on the inside.	O	Conservative
t3_jzyhtm	Biden climate envoy John Kerry is a lifelong joke	BS	Conservative
t3_k0ajsq	Joe Biden Central-Planning Ambitions Dangerous	BP	Conservative
t3_k03aro	Study: Biden received thousands of non-citizen illegal votes in battleground states	EF	Conservative
t3_jzvcjq	Biden's national security adviser pick played key role in Clinton email scandal	BS	Conservative
t3_jzxk30	Study: Noncitizen votes gave Biden wins in Arizona, Georgia -- 'Decimates' claim there's 'no evidence of large-scale fraud'	EF	Conservative
t3_k04ftf	Study: Biden won thousands of illegal votes by noncitizens	EF	Conservative
t3_jzv44u	Trump Supporter Charged with Simple Assault for Breathing on Protesters	TS	Conservative
t3_k04g30	NY Mag Scientifically Proves Biden Supporters Are Racist	BS	Conservative
t3_jzyvw1	Tucker Carlson: Yes, the election was rigged for Joe Biden. Here's how	EF	Conservative
t3_k0wrot	Trump 1st President Since Carter Not to Send Troops Into New Conflict	TP	Conservative
t3_k0k9nr	Donald Trump on Mattis' Remarks that "America First" Policy Should Be Abandoned: "That says it all about Mattis. Obama fired him. I should have fired him sooner."	TP	Conservative
t3_k10tra	BREAKING: Trump pardons former national security adviser Mike Flynn	TP	Conservative
t3_k0klvg	President Trump 'is planning to pardon his national security adviser Michael Flynn'	TP	Conservative
t3_k0p5yb	Only 3% of President Donald Trump voters believe that Joe Biden legitimately won the 2020 election	EF	Conservative
t3_k1057w	Audible Gasps and Laughter From Crowd and Panel at PA Hearing When Witness Says Vote “Spikes” Went 600,000 For Biden and 3,200 For Trump (VIDEO)	EF	Conservative
t3_k0tinx	Newsmax Calls Biden Winner in Mich., Nevada, Pa. Based on Certifications	ER	Conservative
t3_k0xloo	Obama takes jab at Hispanic voters for supporting Trump.	ER	Conservative
t3_k0zuxz	Huge court win lets Trump present ballot evidence, could overturn Nevada result	EF	Conservative
t3_k0j2vo	Predicting a second Trump term, Sidney Powell says 'massive' Georgia lawsuit coming by Thanksgiving eve	EF	Conservative
t3_k0jq0y	Pennsylvania, Arizona, Michigan Legislatures to Hold Public Hearings on Election: Trump Campaign	EF	Conservative
t3_k0l7fa	Watch–Joe Biden: Amnesty for Over 11 Million Illegal Aliens Going to Senate in My First 100 Days	BP	Conservative
t3_k0jilv	White House press caught laughing at McEnany and Trump -- 'They got COVID. They lost the election'	O	Conservative
t3_k0tdrc	CNN Credits Biden for Dow Hitting 30,000 for the First Time: AIR.TV	O	Conservative
t3_k10suc	Days After Pennsylvania Tries To Certify Election – Judge Intervenes For Trump, Blocks Any Further Certification Pending Hearing	EF	Conservative
t3_k0ji3v	PA Rep. Guy Reschenthaler: Pa. Certifying Tainted Results 'Reckless' -- "Secretary Boockvar said Pennsylvania was going to go to Joe Biden before voting even started."	EF	Conservative
t3_k10qr9	BREAKING: Trump pardons former national security adviser Mike Flynn	TP	Conservative
t3_k0xmvl	Huge court win lets Trump present ballot evidence, could overturn Nevada result	EF	Conservative
t3_k0yu2x	Keith Olbermann Unhinged — ‘We need to turn Trump Hotels into prisons for his supporters’…	O	Conservative
t3_k1188p	Without Evidence, Former President Obama Accuses Hispanic Trump Voters Of Bigotry	O	Conservative
t3_k0yjr6	Major LGBT Group Urges Biden to Strip Accreditation of Christian Schools, Colleges	BP	Conservative
t3_k0t3ex	Exit Polls Suggest Little Enthusiasm for Biden among Union Members	O	Conservative
t3_k0szmt	Sorry Media, Trump Is Still President And This Is Still His Stock Market	O	Conservative
t3_k0jbio	Potential Joe Biden White House Staffer Justified Palestinian Suicide Bombers	BS	Conservative
t3_k0w69z	We did it': Fox News owner's wife celebrated Biden's projected presidential win in a tweet	O	Conservative
t3_k131h4	Trump Pardons Michael Flynn -- ‘have a truly fantastic Thanksgiving!’ -- Flynn Tweets Jeremiah 1:19: ‘they shall fight against thee; but they shall not prevail against thee’	TP	Conservative
t3_k0laop	That was weird as s***': White House reporters left bemused by Trump's press appearance	TS	Conservative
t3_k13h4j	Biden says 'we're all in this together' as Dem politicians keep getting caught breaking coronavirus rules	PO	Conservative
t3_k12pis	Obama invites avalanche of criticism with 'condescending' remarks on Hispanic Trump supporters	O	Conservative
t3_k0l9eh	Report: President Trump Plans to Pardon Michael Flynn	TP	Conservative
t3_k114gy	Pres. Trump pardons Mike Flynn	TP	Conservative
t3_k11l8q	Trump announces pardon of former National Security Advisor Michael Flynn	TP	Conservative
t3_k0wh1v	Chris Evans, Zach Braff Want A List Of ‘Trump Enablers’	O	Conservative
t3_k0zib6	Huge court win lets Trump present ballot evidence, could overturn Nevada result	EF	Conservative
t3_k11pj7	President Trump pardons ex-natl security adviser Michael Flynn; ends three-year legal odyssey	TP	Conservative
t3_k0ko0q	Trump told confidants he intends to pardon Michael Flynn: report	TP	Conservative
t3_k11zdw	Trump Addresses Irregularities in Pennsylvania: 'We Won This Election by a Lot'	EF	Conservative
t3_k0usew	Computer repairman at center of 'Biden laptop' scandal closes shop, disappears amid purported death threats	BS	Conservative
t3_k0rt9n	CNBC/Change Poll: Only 3 Percent Of Trump Voters Consider Election Legitimate	EF	Conservative
t3_k0lrpi	Joe Biden is reviving all of his past failures — and it won’t stop	BS	Conservative
t3_k139fk	German Minister of Defence: President Trump was correct to pressure Germany to spend more on defense	TP	Conservative
t3_k12cad	BREAKING: Trump Pardons Former National Security Adviser Michael Flynn	TP	Conservative
t3_k0r5t4	President Trump plans to pardon Michael Flynn: Reports	TP	Conservative
t3_k0jgse	Tucker Carlson Has Epic Rant About the Real Theft of the Election: "The system was rigged against one candidate" (Trump agrees)	EF	Conservative
t3_k0ja69	Biden Picks Swamper Who Falsely Accused Michael Flynn of Russian Collusion as National Security Advisor	BP	Conservative
t3_k12qyb	Alyssa Milano extends 'olive branch to Trump supporters' — and the left-wing, Trump-despising actress gets totally torched	O	Conservative
t3_k0lrz6	Trump reportedly set to pardon Michael Flynn	TP	Conservative
t3_k0ylof	Biden Team Hopes to Reverse Trump’s Policies and Return America to Endless Wars, Stagnation and Despair [Satire](but not really)	BP	Conservative
t3_k12pqx	BREAKING: Michael Flynn granted full pardon by President Donald Trump	TP	Conservative
t3_k12zj1	Trump Legal Team Scored a Big Win in Nevada. Could It Lead to a 2020 Bombshell?	EF	Conservative
t3_k118bv	President Trump pardons Michael Flynn	TP	Conservative
t3_k0u2y7	After President Trump Gets Setback In Pennsylvania – The 3rd Circuit Court Just Granted Donald An Expedited Review	EF	Conservative
t3_k0ybnn	Biden Will Propose 'Path to Citizenship' For 11 Million Illegals First 100 Days in Office, Likely Trigger New Border Crisis	BP	Conservative
t3_k1129d	Trump pardons his former National Security Adviser Michael Flynn	TP	Conservative
t3_k0qpwq	Nearly a Tenth of Biden Voters in Key States Would Not Have Voted for Him Had They Known About Hunter Biden Scandal	BS	Conservative
t3_k11afj	Trump pardons ex-National Security Adviser Flynn	TP	Conservative
t3_k14i15	"Mysterious” Election Day Spike Gave Biden Nearly 600,000 Votes, Only 3,200 for Trump	EF	Conservative
t3_k12ycx	After Years Of Russia Hoax Persecutions, Trump Pardons Michael Flynn	TP	Conservative
t3_k12y22	Tom Cotton: Biden DHS Nominee Mayorkas Disqualified to Lead Agency for Selling Green Cards to Chinese Nationals	BS	Conservative
t3_k0uub6	Is there any doubt that Trump was right to fire James Comey?.	TS	Conservative
t3_k0r69g	Biden: Amnesty for 'Over 11M' Illegals Going to Senate in First 100 Days	BP	Conservative
t3_k0ppz7	Biden’s New Secretary Of State Could Be In Trouble – Emails Show Hunter Biden Requested Meeting With Blinken	BS	Conservative
t3_k0ugpb	Hillary Clinton among names being considered for Biden Secretary of defense.	BP	Conservative
t3_k1049j	Alyssa Milano’s Attempt To Make Peace With Trump Supporters Backfires	O	Conservative
t3_k13unn	Trump pardons former national security advisor Michael Flynn	TP	Conservative
t3_k12rjd	Joe Biden Recites Alphabet To Prove His Mental State ‘strong’	BS	Conservative
t3_k12jio	Afghan Vet Johnny Jones On Biden’s Gun Control Plan: That’ll Trigger 2022 GOP Landslide	BP	Conservative
t3_k0u4x0	President Obama Shares His Disappointment in Evangelical Hispanics Who Voted for Trump	O	Conservative
t3_k0k7wi	US should encourage China's rise, Biden national security pick Jake Sullivan says	BP	Conservative
t3_k0zxou	Barack Obama: Pro-Trump Latinos Cling to Religion	O	Conservative
t3_k0rs78	US election 2020: Biden says White House co-operation 'sincere'	T	Conservative
t3_k0wx36	Biden National Security Adviser Pick Said "Al-Qaeda Is On Our Side" in Syria	BS	Conservative
t3_k0t2ng	Biden's Homeland Security pick flagged by whistleblowers for preferential treatment with visas	BS	Conservative
t3_k12gc8	Trump pardons former national security adviser Michael Flynn	TP	Conservative
t3_k0vsw1	Trump Lawyers Want Rudy Giuliani to Argue in Federal Court Again: Document	TP	Conservative
t3_k0v1z1	Poll: Just 3% of Trump voters believe Biden won fairly, 73% think Trump is the legitimate winner	EF	Conservative
t3_k0j56p	FAKE NEWS: ABC, NBC Suck Up to ‘Diverse’ Biden Picks as ‘Mainstream,’ ‘Not Political’	BS	Conservative
t3_k14p7g	Trump: 2020 'Long Way From Over'	O	Conservative
t3_k11b64	Biden's Policy Proposals Would Harm Economy	BP	Conservative
t3_k0ypop	The Return of Obama–Biden Energy Cronyism. Green lobbyists and other Obama favorites are about to enter a new golden age.	BP	Conservative
t3_k0wvyv	Scarborough on Operation Warp Speed: Trump's Legacy on 'Could Be Considered an Unqualified Success'	TS	Conservative
t3_k0voli	Media fawns over Biden's Cabinet rollout, describes 'being rescued from this craziness' by 'superheroes'	BP	Conservative
t3_k0jwo5	Clyburn: 'I Wish' Bernie Sanders Would Join Biden Administration	O	Conservative
t3_k14v0m	Obama Attacks Trump for Using Same 'Cages' at Border He Used	TS	Conservative
t3_k14cn1	Huge court win lets Trump present ballot evidence, could overturn Nevada result	EF	Conservative
t3_k0k0z2	US should encourage China's rise, Biden national security pick Jake Sullivan says	BP	Conservative
t3_k0rt9t	Georgia secretary of state: My family voted for Trump. He threw us under the bus anyway.	O	Conservative
t3_k1466q	Joe Biden urges nation to ‘forgo family traditions’ on Thanksgiving	BP	Conservative
t3_k10l0l	Alyssa Milano extends 'olive branch' to Trump supporters after months of scathing rebukes	O	Conservative
t3_k14od3	Rep. Reschenthale: 'Premature' for Pennsylvania to Certify Election Results for Biden	ER	Conservative
t3_k0svmv	Media Censoring Negative Biden News May Have Cost Trump The Election Swing State Poll Shows	EF	Conservative
t3_k0kty5	Generation Forever War: Biden’s National Security Picks Herald Return to Hawkish Normalcy	BP	Conservative
t3_k124l8	The Revenge of The Swamp! Biden Lefty Transition, Big Tech Censorship, Truth &amp; Reconciliation!?(The Happy Warrior Podcast)	O	Conservative
t3_k17bp7	Tokyo residents back President Trump, say if Biden wins China wins	O	Conservative
t3_k16wte	Trump Calls on Supporters to Stand Tall: 'Don't Be Intimidated by These People'	O	Conservative
t3_k1e0sd	Joe Biden is slammed for saying he will immediately push a bill for pathway to citizenship for 11 million undocumented people in America 'rather than concentrate on COVID'	BS	Conservative
t3_k1hr9e	Trump Lawyer Jenna Ellis Receives Threats: 'You Deserved to Be Raped'	O	Conservative
t3_k17zpq	Trump Announces He Will Only Leave Office If A Challenger Beats Him In Ritual Combat	EF	Conservative
t3_k1gjra	If Voters Had Known About 8 Stories Media Ignored, Trump Would Have Won, Says Media Watchdog	EF	Conservative
t3_k1jxva	Newsmax/McLaughlin Poll: Two-Thirds of Nation Backs Trump on Recounts	EF	Conservative
t3_k1l71u	Thanksgiving Proclamation: Donald Trump Celebrates 400th Anniversary of Plymouth Rock Landing	O	Conservative
t3_k1eya6	Biden UN, State Dept Picks Are Documented Chinese Communist Party Consultants	BS	Conservative
t3_k1fuat	Overstock founder says he has proof election was rigged for Biden	EF	Conservative
t3_k1fx19	Biden’s Pick for National Security Adviser Sent Classified Emails on Clinton’s Server, Hyped Fake Trump-Russia Collusion Story	BS	Conservative
t3_k18cqo	Trump Exhorts Supporters: Don't Be Intimidated by Dems, Others	O	Conservative
t3_k1b0te	Huge court win lets Trump present ballot evidence, could overturn Nevada result	EF	Conservative
t3_k1isqi	Computer Repairman Who Found Hunter Biden's Laptop Has Vanished, Reports Cite 'Death Threats'	BS	Conservative
t3_k1ahcn	Summary of the kraken: Sidney Powell sues Georgia officials, alleging massive scheme to rig election for Joe Biden	EF	Conservative
t3_k175f3	Huge court win lets Trump present ballot evidence, could overturn Nevada result	EF	Conservative
t3_k1q4qj	Trump Says He'll Leave Office if Electoral College Votes for Biden	T	Conservative
t3_k1qtwn	Biden breaks Obama’s record for lowest number of counties won	ER	Conservative
t3_k1g0n7	Hey look! It’s more of those dead voters that “don’t exist”. This time it’s taken up in court and doesn’t have to deal with Trump, so it might be given fair coverage.	EF	Conservative
t3_k16pbr	Biden urges Americans to 'forgo family traditions' on Thanksgiving to fight COVID-19	BP	Conservative
t3_k1enjh	Biden Taps Staffer Who Said Suicide Bombings Were 'Last Resort' for Palestinians	BS	Conservative
t3_k1c3b7	Poll: 90% of Harvard Freshmen Support Joe Biden	ER	Conservative
t3_k18mt0	LATEST: Trump Pardons Michael Flynn, Who Endured Years of Apparent Prosecutorial Misconduct by FBI	TP	Conservative
t3_k1gfbw	March for Trump' bus tour to demand 'election integrity' -- The "March for Trump", organized by Women for America First, will launch in Palm Beach then wind its way through 16 states, concluding Dec. 12 in Washington, D.C.	EF	Conservative
t3_k18krk	Trump Calls Into the PA State Senate Hearing as Senators Hear Stunning Accounts of Election Irregularities	EF	Conservative
t3_k1pe3o	Mattis didn't disclose ties to China-boosting firm in column slamming Trump's 'America First' policy	TP	Conservative
t3_k18f4u	Rand Paul Says He Will Ask Biden’s Secretary Of State Pick Tony Blinken To Apologize For Supporting War In Iraq	BS	Conservative
t3_k18b3h	Biden: Americans 'Won't Stand' for Election Results Not Being Honored	EF	Conservative
t3_k19ptk	Trump-allied legal activist: GOP vote suppression reminiscent of Jim Crow-era ballot bias	EF	Conservative
t3_k1o2ht	AOC insists Biden can use executive order to cancel student loan debt	BP	Conservative
t3_k1phbw	Justin Webb: Biden’s battle with his leftist party is just beginning	BS	Conservative
t3_k1693z	‘Absolutely No Allegations of Any Fraud’: Pa. Court Rejects Trump Campaign’s Appeal Over 69 Mail-In Ballots	EF	Conservative
t3_k1r7ok	Latest Poll: Two-Thirds of Nation Back Trump on Recounts	EF	Conservative
t3_k1r7g8	Trump Encourages Americans to Offer Thanks to God, Get Together With Family for Thanksgiving	TP	Conservative
t3_k1c2wm	Chinese Media Bark Orders at Biden	O	Conservative
t3_k1fawe	Implications of the Flynn Pardon -- President Trump’s pardon not only ends any injustice to Flynn, but it restores the proper balance to the separation of powers.	TP	Conservative
t3_k1liko	FLASHBACK: John McCain Called Biden Secretary of State Pick Tony Blinken "Unqualified"	BP	Conservative
t3_k18t9c	FakeNYTimes: Donald Trump Refuses to Concede 2024 Election	O	Conservative
t3_k1l71w	Devout Catholic, Joe Biden, doesn't know that when pronouncing probably the most famous book in the bible, the P is silent in Psalms.	BS	Conservative
t3_k1qpth	Biden’s National Security Adviser Wants To ‘Encourage China’s Rise’	BP	Conservative
t3_k1r61l	Joe Biden Tries to Quote Book in the Bible, It Goes Horribly Wrong -- "Devout Catholic" Joe Biden doesn't know the "P" in "Psalmist" is silent, not the "s".	BS	Conservative
t3_k1r3jc	Infographic: The 4-Year-Long Campaign Against Trump	O	Conservative
t3_k1q3jw	Ken Timmerman: Revenge of the Swamp Creatures (Biden's Cabinet)	BS	Conservative
t3_k1esn1	Clemency Seekers Likely to Descend Upon Trump White House. Dershowitz says the president "was very interested in the concept of the pardon power being more than just clemency, but being part of the system of checks and balances for excessive legislative or judicial actions."​	TP	Conservative
t3_k1hu8z	Joe Scarborough: Won't Go Back to GOP After It Backed Trump	TS	Conservative
t3_k1okst	Joe Biden’s Moderate Mask Slips Off – He Just Admitted He’s Planning To Execute A “Very Progressive Agenda”	BS	Conservative
t3_k1deyj	Barack Obama: Pro-Trump ‘Evangelical Hispanics’ Care More About Abortion than ‘Cages'	O	Conservative
t3_k1gm65	China threatens economic pain for UK over Huawei crackdown as Trump exit looms	T	Conservative
t3_k1c44i	Report: Israel's Army Preparing in Case Trump Strikes Iran	TP	Conservative
t3_k1pdp5	How (the Great President) Trump’s vaccine effort produced results at ‘warp speed’	TP	Conservative
t3_k1g6mh	Trump does the right thing by pardoning Gen. Flynn | Spectator USA	TP	Conservative
t3_k1fb6q	Will Obama Torture Apologists Make a Triumphant Return to Joe Biden's White House?	BP	Conservative
t3_k16q8a	Former Acting ICE Director Tom Homan warns of 'outta control' border under a Biden administration	BP	Conservative