Name	Title	Coding	Subreddit
t3_jzc3li	New Jersey Lawmaker Pushes To Disbar Rudy Giuliani For Deceitful, ‘Absurd’ Election Cases	Other	politics
t3_jzi4ou	With nearly all votes counted, the 2020 presidential election wasn't that close	Other	politics
t3_jznsvu	Georgia GOP Senator Kelly Loeffler Just Got Caught Violating the Law | Will the Senate’s richest member be held to account for her blatantly illegal solicitation of campaign cash?	Other	politics
t3_jzgfji	Why Won’t Emily Murphy Just Do Her Job? In delaying the transition, the General Services Administration chief appears to be making an ideological choice.	Other	politics
t3_jzj8pk	Congress should cancel its Thanksgiving recess and pass another stimulus bill	Other	politics
t3_jzi95i	Refusing to certify legitimate votes is a felony | Opinion	Other	politics
t3_jzhrk4	The left is accused of authoritarianism – but it's the right that gets away with it	Other	politics
t3_jzhnl4	Ted Cruz Tweeted A Tone-Deaf Thanksgiving Meme While Texas Morgues Overflowed With COVID Victims	Other	politics
t3_jzlncn	This Is the Beta Test for a Future Where Republicans Will Simply Never Accept a Democratic Victory	Other	politics
t3_jzi3gz	The Republican Party has split in two. Let’s keep it that way.	Other	politics
t3_jzgni2	Can This Get Any More Pathetic? The president and his enablers may look like fools, but they are causing real damage.	Other	politics
t3_jzie6k	Michigan set to certify election results Monday despite GOP challenge	Other	politics
t3_jzh1lm	Lincoln Project attacks "unpatriotic" and "dangerous" Republican rising stars in new ad	Other	politics
t3_jzgzab	Epidemiologist warns of “contagion” of violent speech coming “from the White House”	Other	politics
t3_jz9uzj	DeSantis hires Ohio Uber driver to rig Covid stats	Other	politics
t3_jzjx1p	Our democracy is holding. Americans will remember who defended it — and who didn’t.	Other	politics
t3_jzpxy7	Yes, We Should Still Get Rid of the Electoral College	Other	politics
t3_jz91j4	Democrats must fight for $15 — for Georgia and for the future	Other	politics
t3_jzjvt3	Republicans created an anti-democratic mob	Other	politics
t3_jzs6ku	Michigan AG warns on election fraud claims: A false claim of criminal activity is a crime	Other	politics
t3_jz9z0z	Scranton, Pennsylvania, honors famous 'scrappy kid' turned President-elect	Other	politics
t3_jzho2z	A North Texas superintendent is openly defying the state mask mandate in schools. No one is stopping him.	Other	politics
t3_jzshte	Dianne Feinstein to step down as top Democrat on the Senate Judiciary panel | The 87-year-old was criticized for her handling of Amy Coney Barrett's contentious Supreme Court confirmation hearings	Other	politics
t3_jzgxk3	GOP Sen. Cramer says it's 'past time' to start transition as challenges continue	Other	politics
t3_jzoz36	Wisconsin GOP chair says Republicans are "trying to disenfranchise people," amid post-election turmoil	Other	politics
t3_jzkpsf	The Birther Myth Stuck Around For Years. The Election Fraud Myth Might Too.	Other	politics
t3_jz8fzj	A Hail Mary': Lt. Gov. Fetterman Responds To Pennsylvania Mail-In Ballot Lawsuit From Republicans	Other	politics
t3_jzk0l9	Allegheny Co. Board Of Elections Votes 2-1 To Certify General Election Results	Other	politics
t3_jz9q93	Georgia GOP shifts strategy to prioritize vote-by-mail ahead of runoff elections	Other	politics
t3_jzhdsi	Florida Republican Lawmaker Wants an Accused Murderer Elected to Congress	Other	politics
t3_jzkwh8	Iran in the Crosshairs?' Reports of Secret Meeting Between Netanyahu, MbS, and Pompeo Spark Fears of War Plot	Other	politics
t3_jznoa2	Supreme Court’s Lack of Attention to GOP Emergency Petition Suggests High Court ‘Has No Interest’	Other	politics
t3_jz9j27	Governor Cuomo Calls on Congress to Renew and Expand Critical Support Programs for Unemployed Americans Amid COVID-19 Pandemic	Other	politics
t3_jzoq9m	Georgia extends use of absentee ballot drop boxes for Jan. 5 runoff amid surge in requests	Other	politics
t3_jzolvy	Surgeon General Reminds WH That COVID Restrictions Apply There Too	Other	politics
t3_jzbdl7	Socialism Is Bad Until a Capitalist Like David Perdue Gets Paid | Opinion	Other	politics
t3_jziiq3	Attention, Sen. Grim Reaper: More will die without another stimulus bill	Other	politics
t3_jzjwo0	Profiles in Cowardice	Other	politics
t3_jznpns	Why the Republicans Are Like the 1860 South: Don’t like the election’s outcome? Then split the nation.	Other	politics
t3_jzke7v	Georgia Senate race reminds Republicans they don't have a lock on 'God talk'	Other	politics
t3_jz9qk5	Two more House members announce they have Covid-19	Other	politics
t3_jzg5ak	Sen. Schumer pushes govt. to invoke Defense Production Act to mitigate COVID-19 surge	Other	politics
t3_jznrcd	Pentagon reports $5B in improper payments to civilian workforce	Other	politics
t3_jzqixu	Democrats reject GSA offer to delay briefing on transition	Other	politics
t3_jz8w6q	Republicans Rewrite an Old Playbook on Disenfranchising Black Americans	Other	politics
t3_jzhdky	Eight mayors: We need a Marshall Plan for Middle America	Other	politics
t3_jzq3ey	Chairman Nadler to GSA: Perform Your Duty and Ensure Peaceful Transition of Power	Other	politics
t3_jzmmoz	For interracial couples, Kamala Harris and Doug Emhoff are a ‘monumental’ symbol	Other	politics
t3_jzq735	Record amount of absentee ballots requested for Georgia runoff elections	Other	politics
t3_jzpdev	Mohave County certifies election results, becoming final Arizona county to do so	Other	politics
t3_jzk542	Economists call for more stimulus checks	Other	politics
t3_jzmmfn	Ted Cruz Gets His Election Predictions Thrown Back In His Face	Other	politics
t3_jzk7gl	Deb Haaland Could Shatter Yet Another Glass Ceiling as the First Ever Native American in a Presidential Cabinet	Other	politics
t3_jzgw5s	Goodbye To All That — Leaving the GOP	Other	politics
t3_jzqv3f	US can kill its own citizens without review when state secrets are involved, DOJ lawyer argues	Other	politics
t3_jztaah	Dianne Feinstein to step down as top Democrat on Senate Judiciary Committee following SCOTUS backlash	Other	politics
t3_jzmrvz	Surgeon General Adams: All Americans, even at the White House, should avoid large holiday gatherings	Other	politics
t3_jzkrud	Portman: No proof of mass fraud that would change election result	Other	politics
t3_jzpj8x	The Real Lesson of Herman Cain’s Death | For Republicans, Black people’s suffering will always be someone else’s problem.	Other	politics
t3_jzpi1q	400 Years After the ‘First Thanksgiving,’ the Tribe Who Fed the Pilgrims Continues to Fight for Their Land Amid Another Epidemic	Other	politics
t3_jzi65k	Israeli PM Netanyahu secretly flew to Saudi Arabia for meeting with Pompeo and crown prince	Other	politics
t3_jzae3i	L.A. County suspends outdoor dining at restaurants as coronavirus surges	Other	politics
t3_jzou6q	N.Y. Senate Democrats declare supermajority in Albany	Other	politics
t3_jzp7an	Members of law enforcement sue to halt marijuana legalization in South Dakota	Other	politics
t3_jzihp1	‘Society is broken’: Users are pissed that people are being paid to stand in long COVID testing lines — 'This is so f*cking dystopian.'	Other	politics
t3_jznyq8	GOP Senator Portman says there's "no evidence" that election fraud would change results "in any state"	Other	politics
t3_jzhj8e	As Arizona Counties Certify Election Results, Senate President Karen Fann Still Looking For Fraud Evidence	Other	politics
t3_jzleel	Wisconsin presidential recount in 4th day, with few changes	Other	politics
t3_jztrbg	Dianne Feinstein to step down as top Democrat on Senate Judiciary Committee following SCOTUS backlash	Other	politics
t3_jzlg7d	How to Help the Democrats Win Georgia	Other	politics
t3_jzospq	Inaccurate early vote count in one Michigan county was a human error, not a failure of the software	Other	politics
t3_jzslfs	Woman Says Georgia ICE Facility Gave Her Unwanted Gynecological Surgery. Now She's Being Deported	Other	politics
t3_jzqgra	Workers go on strike at 11 nursing homes in Illinois, demanding higher wages and COVID-19 pandemic hazard pay	Other	politics
t3_jzrueo	Robert Reich: The Republicans' Legacy is Profiles in Cowardice	Other	politics
t3_jzlr1s	The "What happened in your state last week?" Megathread, Week 46	Other	politics
t3_jzuc80	Ironically enough, it’s Rudy Giuliani who has ties to Venezuela	Other	politics
t3_jzquea	Democrats 'Insist' On Tuesday Briefing By GSA Head On Delayed Transition	Other	politics
t3_jzm1n1	Mask Mandates Work To Slow Spread Of Coronavirus, Kansas Study Finds	Other	politics
t3_jzqzwb	Stocks jump on news of Yellen as Treasury pick	Other	politics
t3_jzmhm7	Watch live at 1: Board of State Canvassers to vote on certifying Michigan election results	Other	politics
t3_jzpcaw	Republican Wisconsin congressman Bryan Steil tests positive for COVID	Other	politics
t3_jzpbbh	Could Giuliani Really Get Disbarred? Ethics Complaints Explained	Other	politics
t3_jzjfiq	White House plans holiday party as Americans urged to stay home	Other	politics
t3_jztyd2	GSA chief says decision to allow transition to begin was 'solely mine'	Other	politics
t3_jzn33v	Whitmer, courts could take action if Board of State Canvassers fails to certify	Other	politics
t3_jzshll	Feinstein won't seek top Judiciary Committee spot following complaints from progressives	Other	politics
t3_k048pi	Stacey Abrams says 750K Georgians have requested ballots for runoff	Other	politics
t3_jzumbx	AOC criticises Mitch McConnell for dismissing Senate as coronavirus cases spike: 'I don't know how these people can sleep at night'	Other	politics
t3_k0cl04	‘People are going hungry as you tweet from vacay’: AOC doubles down attacks on senate for failure to pass Covid relief bill	Other	politics
t3_k08f1c	Congressman seeks to have Rudolph Giuliani disbarred over attempts to overturn election	Other	politics
t3_k03olk	Jaime Harrison launches new PAC to help Democrats in Georgia runoffs as he eyes DNC chair	Other	politics
t3_k050s7	Seattle's 2021 budget includes millions for community programs and 18% cuts to police	Other	politics
t3_jzw72b	A dark money mystery in Florida centers on the campaign of a spoiler candidate who appeared to help a Republican win by 32 votes	Other	politics
t3_k04weg	Georgia Dems will knock on doors with Senate at stake	Other	politics
t3_k01wfe	Giuliani admits to exaggerating claims of fraud after saying Detroit had more voters than citizens	Other	politics
t3_k0631x	Atlanta Hawks and Falcons team up to open early voting site for key Georgia runoff	Other	politics
t3_k07mq6	Rudy Giuliani Went to Court and Made a Compelling Argument—for His Own Disbarment	Other	politics
t3_k035vy	Attorney General Barr Will Go Out With a Whimper, Not a Bang	Other	politics
t3_k08wp4	Time for Democrats to Drain the Real Swamp	Other	politics
t3_jzzyfs	Following the money behind two apparent shill candidates in Florida state Senate races	Other	politics
t3_k06vvg	I'm exaggerating a bit': Giuliani's voter fraud admission	Other	politics
t3_k05zlx	‘He’s Not Kushner’: Israelis Who’ve Worked With Blinken Welcome His Pick as Secretary of State	Other	politics
t3_k0ddv4	N.J. cops must wear body cameras under new laws Gov. Murphy just signed	Other	politics
t3_k04rl6	Ocasio-Cortez knocks McConnell for dismissing Senate without passing COVID-19 relief	Other	politics
t3_k09xpl	Michigan AG investigating threats against Wayne County canvassers	Other	politics
t3_k06v6v	Jaime Harrison: "We have to transform the Democratic Party"	Other	politics
t3_k0aqul	The Good News Is That John Kerry Believes In Climate Change	Other	politics
t3_k06z58	Texts: US census manager told counters to use fake answers	Other	politics
t3_k0bzmf	‘Ghost candidates’ blamed for siphoning votes in Florida Senate races	Other	politics
t3_jzv1j3	Melania Still Has to Give a F--k About Christmas	Other	politics
t3_k092fh	An outstanding choice.’ Elizabeth Warren praises choice of Janet Yellen as Treasury secretary - The Boston Globe	Other	politics
t3_jzwbqe	South Dakota governor refuses to mandate masks despite record-breaking coronavirus spike	Other	politics
t3_jzzi17	White Nationalist President to Veto Defense Bill if Military Bases Don’t Keep Confederate Names	Other	politics
t3_k041go	Pa. Lt. Gov. Fetterman says GOP 'put a Grubhub order in for chaos' after the election	Other	politics
t3_k08tqa	Why Stacey Abrams Is Confident Georgia Will Stay Blue	Other	politics
t3_jzxj0i	Law enforcement officers ask courts to stop legal marijuana	Other	politics
t3_jzvfsb	It Was a Good Day for Democracy	Other	politics
t3_k0b2ox	Nevada Supreme Court certifies election results	Other	politics
t3_jzvphc	After criticism, Feinstein to step down as top Judiciary Dem	Other	politics
t3_k01rr8	QAnon Lies Are Taking Over Election Conversations Online	Other	politics
t3_k06lgn	Unsanitized: We’ve Given Almost Nothing to States and Cities for Vaccine Distribution	Other	politics
t3_k0ekqi	Ocasio-Cortez, Cruz trade jabs over COVID relief: People 'going hungry as you tweet from' vacation	Other	politics
t3_k05exe	The ruling elite's war on truth: America's leaders are increasingly disconnected from reality	Other	politics
t3_jzy57e	Ted Cruz Mocks Covid-19 Safety Warnings As Texans Die | All In | MSNBC	Other	politics
t3_k0bwrl	How do we avoid future authoritarians? Winning back the working-class is key	Other	politics
t3_k09n8b	Go Big, and Stay Big': Economists Call for $3 Trillion Covid Relief Package to Stop Nation's Descent Into Ruin | "The Senate's failure to provide crucial relief and recovery aid has left families without a lifeline and will severely damage prospects for recovery."	Other	politics
t3_k0957p	Jaime Harrison Would Be ‘All In’ If Called On To Lead DNC	Other	politics
t3_k0dyl7	William Barr’s Bloodthirsty Lame Duck Execution Spree Is Unprecedented	Other	politics
t3_k0d0cj	New York Democrats Claim Supermajority in State Senate	Other	politics
t3_jzw7lb	Aaron Van Langevelde Has More Spine Than the Entire Republican Caucus in Congress	Other	politics
t3_k03mra	USS John S. McCain challenges Russia’s claims to Peter the Great Bay in Sea of Japan	Other	politics
t3_k0econ	Key House Democrat Asks SEC to Find Out if Perdue Sub Deal Was as Shady as It Looks	Other	politics
t3_k08qm5	Stacey Abrams Says More Than 750K Have Requested Ballots for Senate Runoff	Other	politics
t3_jzycy0	David Dinkins, NYC’s first black mayor, dead at 93	Other	politics
t3_k03sd7	The Snake-Oil Salesmen of the Senate	Other	politics
t3_k06ieq	Foreign observers shocked by chaos over U.S. election	Other	politics
t3_k05le1	Ohio Senior Assistant Attorney General cited for leaving two Upper Arlington crashes on same morning	Other	politics
t3_jzuxnt	Feinstein to step aside as top Democrat on Senate Judiciary Committee	Other	politics
t3_k09dp7	Despite the CDC’s Eviction Ban, Thousands of Tenants Are Losing Their Homes | Across the country, tenants are finding that the eviction moratorium is riddled with loopholes and ineffectively enforced.	Other	politics
t3_k095lc	Postal union leaders: Pandemic-driven mail decline emphasizes need for USPS aid	Other	politics
t3_k0fxum	House Democrats Vow To Vote On Recreational Marijuana	Other	politics
t3_k0cqap	On day five of election recounts in Milwaukee, all observers were given poop emoji wristbands from Wisconsin Center staff	Other	politics
t3_k04bov	The Tragedy of the 2020 Census	Other	politics
t3_k0f8s1	"Boy, did we screw up": Charles Koch renounces partisanship while pouring money into Georgia GOP	Other	politics
t3_k09tlo	Sidney Powell is a beacon of hope to sad Qanon supporters	Other	politics
t3_jzx0m3	Black Caucus: Renaming Confederate bases must be part of final defense bill	Other	politics
t3_k0e0kx	Minnesota certifies 2020 election results	Other	politics
t3_k0c4ug	Nearly 400 unopened absentee ballots from Milwaukee's south side found during recount	Other	politics
t3_k04nc9	Ted Cruz, AOC spar over delayed COVID relief after McConnell approves Senate recess	Other	politics
t3_k0fuja	Last whistleblower fired from Texas Attorney General Ken Paxton's office days after suing for retaliation	Other	politics
t3_k0f9u0	Education Department removed tool for defrauded students 9 days after launch	Other	politics
t3_k0d1ti	Mnuchin to Put $455 Billion in Funds Out of Yellen’s Easy Reach	Other	politics
t3_k0fm53	Indiana Asks the Supreme Court to Let Them Strip Rights from Same-Sex Parents | The justices have shown interest in a case that could begin the rollback of marriage equality.	Other	politics
t3_k0evew	Give it a rest, Republicans — no one wants to take away Turkey Day	Other	politics
t3_k0cpxm	Dianne Feinstein to step down as top Democrat on Senate judiciary panel	Other	politics
t3_k0ayzy	Federal stimulus would give "more degrees of freedom" for possible lockdown, Gov. Phil Murphy says	Other	politics
t3_k0ga6s	AOC says Republicans holding stimulus check hostage over demand for corporate COVID immunity	Other	politics
t3_k09dl7	Minnesota state board meets to certify election results	Other	politics
t3_jzxhxb	Georgia State Election Board to consider emergency election rules for Jan. runoff	Other	politics
t3_k0eubu	Ossoff, Warnock to knock on doors in runoff campaigns	Other	politics
t3_k05yh2	The democracy hangs on — by just enough	Other	politics
t3_jzwayf	Democrats were passive and got steamrolled — because the Republicans were aggressive	Other	politics
t3_jzvlup	Yellen closes in on becoming first woman to hold three most powerful economic posts	Other	politics
t3_k07bl7	Census manager told counters to use fake answers, texts show	Other	politics
t3_k0en5g	Trans senator Sarah McBride gives artful masterclass in putting spiteful trolls in their place	Other	politics
t3_k0efh3	We’ll Soon Be Rid of Steve King —But Not His Demagoguery	Other	politics
t3_k0sd46	Under Governor Noem – South Dakota leads the world in death rate From COVID-19 - World expert says Noem’s lack of leadership is “Equivalent to manslaughter	Other	politics
t3_k0rk1f	Perdue and Loeffler’s Well-Timed Stock Trades Give Georgia Democrats an Opening — “These are just bad people who you shouldn’t be trusting”	Other	politics
t3_k0sqtf	Newsmax CEO Says Its Coverage Is Not Accurate, They Have No Evidence of Election Fraud	Other	politics
t3_k0siww	U.S. citizens detained for speaking Spanish at Montana grocery store settle suit against U.S. Customs and Border Protection	Other	politics
t3_k0t2ws	US border patrol closes ‘kids in cages’ detention facility until 2022	Other	politics
t3_k0tiv7	Key Senate Republican faces questions about well-timed investments	Other	politics
t3_k0pth3	ICE Expelled 33 Immigrant Children Back To Guatemala After A Judge Said They Couldn't	Other	politics
t3_k0rl5c	With US in COVID-19 panic, Sen. Perdue saw stock opportunity	Other	politics
t3_k0q2dk	Happy Thanksgiving to All Those Who Told the Truth in This Election | Civil servants, elected officials and judges did their jobs and protected democracy.	Other	politics
t3_k10dnw	Sen. Perdue Insisted He Had No Input At All On Stock Buys. New Evidence Shows He Did.	Other	politics
t3_k0jqf8	Republican John James concedes in Michigan Senate race	Other	politics
t3_k0xeu2	Indigenous people across the US want their land back -- and the movement is gaining momentum	Other	politics
t3_k0yte4	Stock Trades by Senator Perdue Said to Have Prompted Justice Dept. Inquiry	Other	politics
t3_k0qsap	It Wasn't Ideology That Sank House Democrats. It Was Bad Strategy.	Other	politics
t3_k0k93l	Bid to hold another massive pro-gun rally in Virginia thwarted when gun-control advocates got permits first	Other	politics
t3_k0swyw	Amid Covid panic, Georgia Sen. Perdue saw stock opportunity	Other	politics
t3_k0ul6i	Democrats Claim Veto-Proof Majority in N.Y. Senate, Pressuring Cuomo	Other	politics
t3_k0uokq	Ga. Sen. Perdue boosts wealth with well-timed stock trades	Other	politics
t3_k118m2	‘An Admission of Wrongdoing, For Sure’: NRA’s Tax Returns Reportedly Show Top Executives Diverted Significant Assets for Personal Use	Other	politics
t3_k0mgkj	Bernie Sanders backs Alabama Amazon unionization: ‘Mr. Bezos...must not interfere’	Other	politics
t3_k0vhf3	Ossoff calls on Georgia Republicans Perdue and Loeffler to require masks at events as COVID surges	Other	politics
t3_k0jc0t	It’s Not That Complicated. Cancelling Student Debt Is Good.	Other	politics
t3_k0u6np	Congress Isn't Passing Pandemic Relief, But They Are Passing The Coronavirus	Other	politics
t3_k0j6un	Unequal Justice: The Treachery of Samuel Alito — His record of arch-conservatism makes him more closely akin to a Fox News host than a Supreme Court Justice.	Other	politics
t3_k0x68f	Permit Denied for Alaskan Mine Project	Other	politics
t3_k0xnjr	Ga. Sen. Perdue Boosts Wealth With Well-Timed Stock Trades. The Republican senator quickly sold off and bought the same stock in the early days of the pandemic, avoiding a sharp loss.	Other	politics
t3_k0uube	America Is Run by Geezers | In an election between two septuagenarians, the elderly dominated turnout like never before—more than offsetting a surge in the youth vote.	Other	politics
t3_k12uem	FBI Investigated Georgia Republican Sen. David Perdue Over Suspicious Stock Trades	Other	politics
t3_k0ta2a	COVID-19 Sick Leave Likely Prevented Thousands Of Cases. It’s About To Expire.	Other	politics
t3_k0ud5r	Jewish leaders defend Raphael Warnock after Loeffler attacks	Other	politics
t3_k0xyvy	GOP poised to gerrymander its hold on power — Democrats fall short in nearly every key state. Republicans will have power to gerrymander 188 congressional districts while Dems hold control over just 73 seats	Other	politics
t3_k0sowo	U.S. border officials close Texas warehouse where chain-link ‘cages’ for migrants became a symbol of mistreatment	Other	politics
t3_k0xpps	Army Corps says no to massive gold mine proposed near Bristol Bay in Alaska	Other	politics
t3_k0tpuc	More than 125 economists, including Obama's former top economic advisor, sign a letter urging Congress to send a 2nd round of $1,200 stimulus checks	Other	politics
t3_k0swzs	Julia Louis-Dreyfus and Veep Cast to Reunite for Virtual Table Read to Get Out the Vote in Georgia — The Veep cast is getting together to do a table read of the episode “Mother,” which follows a recount during a presidential election.	Other	politics
t3_k0vb5w	Four Seasons, Part II? Maddow Finds Something Weird In Next Big Giuliani Event	Other	politics
t3_k0jcpt	You don’t have a ‘right’ to a lawyer when you’re trying to steal an election	Other	politics
t3_k0s3op	Wall Street rocks as food lines grow	Other	politics
t3_k0pyq3	Jane Mayer: Charles Koch’s partisan regrets are part of cyclical ‘charm offensive’	Other	politics
t3_k0mtpo	Canceling Medical Debt Is a Moral Imperative	Other	politics
t3_k0ztis	“Stop the Steal” Republicans Are the New Anarchists | In Georgia’s runoffs and across the country, the radicals are on the right.	Other	politics
t3_k0sjtf	Republicans Rediscover the Dangers of Selling Bunk to Their Constituents - Cynical public speech aimed at winning political power has consequences.	Other	politics
t3_k130g5	Romance novelists raise $400,000 for Georgia Senate races – with help from Stacey Abrams	Other	politics
t3_k0wnze	Janet Yellen will champion Main Street, not Wall Street	Other	politics
t3_k10oqt	Manhattan DA appeals Manafort dismissal to NY’s high court	Other	politics
t3_k1176e	‘Thanksgiving leftovers won’t taste as good if you’re on a ventilator,’ health department warns	Other	politics
t3_k137ay	House Democrats subpoena private prison operator in forced hysterectomy case	Other	politics
t3_k0tcni	Fauci urges Americans to sacrifice traditional Thanksgiving to save lives	Other	politics
t3_k0z5ed	David Perdue: GOP Senator faces scrutiny over stock trades made as Covid spread in US	Other	politics
t3_k0ya7w	2 Senators Introduce National Face Mask Legislation as U.S. Sees Highest COVID Daily Death Toll Since May	Other	politics
t3_k0veud	David Perdue Boosted Wealth With Well-Timed Stock Trades As Pandemic Hit	Other	politics
t3_k0jx9o	Pardon for Michael Flynn under discussion at the White House	Other	politics
t3_k0y9te	Laura Ingraham Gives Fox Viewers a Dose of Reality: It’s Over	Other	politics
t3_k0re9j	He's an ex-Proud Boy. Here's what he says happens within the group's ranks	Other	politics
t3_k0xdq1	Manhattan DA appeals dismissal of Manafort charges to NY high court	Other	politics
t3_k0ymx4	Scientists Are Becoming More Politically Engaged	Other	politics
t3_k0v6lp	Here's something to give thanks for this Thanksgiving: our democracy survived	Other	politics
t3_k0tgez	A growing number of Americans are going hungry | 26 million now say they don’t have enough to eat, as the pandemic worsens and holidays near	Other	politics
t3_k144y4	Sen. David Perdue’s Stock Trading Continues to Have Remarkable Timing	Other	politics
t3_k0x7ag	University of the Arts faculty in Philadelphia have voted to unionize	Other	politics
t3_k0j3yv	Rudy Giuliani honors David Dinkins in death but led racist rally against him in office	Other	politics
t3_k106ie	Mississippi Gov. Refuses Statewide Mask Mandate, Says Health Experts Are 'Completely Wrong' About Its Effectiveness	Other	politics
t3_k10s9c	L.A. County moves to create new juvenile justice system focused on 'care,' not punishment	Other	politics
t3_k0w618	Ga. Sen. Perdue boosts wealth with well-timed stock trades	Other	politics
t3_k10hpx	The 2020 election wasn't 'stolen.' Here are all the facts that prove it.	Other	politics
t3_k0kuz5	More than 100 million Americans are out of the labor force	Other	politics
t3_k1418a	Romance Novelists Raise Nearly $400,000 for Dems in Georgia Runoff	Other	politics
t3_k12px0	DeSantis won’t answer questions about anything. Where has he been?	Other	politics
t3_k10vq1	WH Trade Adviser Urges More COVID Relief, Including Stimulus for Families and Extending Unemployment Compensation	Other	politics
t3_k0zt0z	Even in a Pandemic, the Billionaires Are Winning	Other	politics
t3_k13kds	Fauci asks Americans to ‘sacrifice’ Thanksgiving in COVID-19 plea	Other	politics
t3_k13foo	Divided government is a path to disaster. Why won’t voters admit it?	Other	politics
t3_k0iyr2	Mnuchin Plans to Put $455 Billion Beyond Yellen’s Easy Reach	Other	politics
t3_k0zji0	With U.S. in COVID-19 panic, Georgia Sen. Perdue saw stock opportunity	Other	politics
t3_k0v8wb	With US in COVID-19 panic, Sen. Perdue saw stock opportunity	Other	politics
t3_k0ukem	Fox News Reaches Settlement With Parents of Seth Rich: A lawsuit they filed in 2018 over the network’s coverage of the murder of Mr. Rich, who had been a Democratic aide, comes to an end.	Other	politics
t3_k0rwe4	Veep' Cast Revisits Recount Episode to Get Out the Vote in Georgia	Other	politics
t3_k147eo	Obama: Republican Party members believe 'white males are victims'	Other	politics
t3_k0uogf	U.S. hits highest death toll since May with hospitals already full	Other	politics
t3_k12s6u	Cannabis group files to defend constitutional amendment	Other	politics
t3_k0jo5y	The Michigan GOP’s Fake Voter Fraud Scandal	Other	politics
t3_k13y9z	White House Thanksgiving proclamation calls for Americans to 'gather' even as Covid-19 surges	Other	politics
t3_k10v9n	Environmentalists Cheer First-Ever US Climate Envoy	Other	politics
t3_k138hg	Denver Mayor Flies to Texas for Thanksgiving After Urging City Residents to Avoid Travel Due to COVID	Other	politics
t3_k0khew	Why You Don’t Mess Around With Presidential Transitions	Other	politics
t3_k11uys	With US in Covid-19 panic, Georgia GOP Sen. Perdue saw stock opportunity	Other	politics
t3_k0siza	Record Turnout Helped Texas Republicans, So Why Are They Still Pushing to Make It Harder to Vote?	Other	politics
t3_k10pyg	U.S. Shutters Warehouse Where Migrants Were Kept in ‘Cages’	Other	politics
t3_k1gh9w	Bernie Sanders Says U.S. Can Cancel All Student Debt if It Can Give the Top 1% $1 Trillion in Tax Breaks	Other	politics
t3_k1j7mf	"Where the f***ing stimulus at?": TikTok video rant at Mitch McConnell watched Over 2 million times	Other	politics
t3_k1fgge	Black Lives Matter raising half a million for Democrats in Georgia Senate runoffs	Other	politics
t3_k1g6bn	Republicans are right: democracy is rigged. But they are the beneficiaries	Other	politics
t3_k16b8b	Joe Scarborough to Nicolle Wallace: Some of our old friends, ‘are more loyal to a failed reality TV host’ than to the Constitution	Other	politics
t3_k1hymr	A(nother) Georgia GOP Senator Was Reportedly Investigated for Insider Trading	Other	politics
t3_k1gyz7	Sidney Powell Mocked, Scorned, Ridiculed and More Over Clumsy, Rambling, Typo-Filled ‘Kraken’ Lawsuits	Other	politics
t3_k1dhh7	Major shift at Supreme Court on Covid-19 orders — the Supreme Court voted 5-4 to bar New York state from reimposing limits on religious gatherings	Other	politics
t3_k1l6cs	Sotomayor Calls Supreme Court’s N.Y. Pandemic Ruling A ‘Deadly Game’	Other	politics
t3_k18o1l	Indiana asks Supreme Court to strip parental rights from gay couples &amp; they may succeed - The United States Supreme Court is taking unusual steps that could start the unraveling of marriage equality.	Other	politics
t3_k1m128	Florida governor Ron DeSantis accused of ‘killing spree’ after extending ban on cities from imposing own mask mandates. Miami-Dade mayor Daniella Levine Cava calls decision ‘deeply frustrating’	Other	politics
t3_k1j7py	A Georgia Republican official named as plaintiff by Sidney Powell says he never agreed to take part in lawsuit	Other	politics
t3_k18568	John Fetterman, Pennsylvania's lieutenant governor and a rising star in the Democratic Party, isn't a progressive. He says he's just being honest.	Other	politics
t3_k1maw4	Sidney Powell's 'Kraken' Voter Fraud Lawsuits Ridiculed by Legal Experts Over Typos, Lack of Evidence	Other	politics
t3_k15uit	South Dakota Police File Lawsuit to Block Measure Legalizing Marijuana Approved by Voters	Other	politics
t3_k15vll	GOP effort to invalidate more than 2.5 million votes in Pennsylvania dealt another setback	Other	politics
t3_k1jnzw	Pennsylvania Tells Top Court There Is ‘No Conceivable Justification’ for Judge’s Certification Order	Other	politics
t3_k1n5f3	Wyoming’s Governor Contracts Coronavirus After Condemning Mask Mandates in Favor of ‘Personal Responsibility’	Other	politics
t3_k1mr2m	Justice Sotomayor Upbraids SCOTUS Majority for ‘Playing a Deadly Game’ With COVID Restrictions	Other	politics
t3_k17ju3	Army Corps of Engineers Denies Permit To Controversial Alaska Gold Mine	Other	politics
t3_k1ny6m	The Rotting of the Republican Mind	Other	politics
t3_k1fpvw	New York Times: Justice Department probed Georgia Sen. David Perdue's stock sales at beginning of pandemic	Other	politics
t3_k1h9wx	This can't wait.' Why long food lines signal need for more coronavirus stimulus aid	Other	politics
t3_k19iw5	Splitting 5 to 4, Supreme Court Backs Religious Challenge to Cuomo’s Virus Shutdown Order	Other	politics
t3_k18jjk	Judge throws out lawsuit filed by Republican Dan Rodimer over election results	Other	politics
t3_k1mqix	Cuomo blames new conservative majority for High Court's COVID-19 decision	Other	politics
t3_k1e03u	Amy Coney Barrett plays decisive role as Supreme Court bars New York COVID restrictions on religious services	Other	politics
t3_k1hghp	Money promised to combat US overdose crisis sits unused	Other	politics
t3_k1gk3c	Supreme Court Blocks New York COVID-19 Restrictions On Religious Gatherings It was the first major decision since Justice Amy Coney Barrett joined the nation’s highest court.	Other	politics
t3_k1k1ey	Two School Districts Had Different Mask Policies. Only One Had a Teacher on a Ventilator.	Other	politics
t3_k19zgw	Amy Coney Barrett casts deciding vote to block limit on religious gatherings	Other	politics
t3_k1kcpr	Denver’s mayor urged residents to avoid Thanksgiving travel. Then he flew cross-country to see family.	Other	politics
t3_k188m8	A New Political Force Emerges in Georgia: Asian-American Voters	Other	politics
t3_k1hg7q	New Hampshire Republicans want to impeach the state's GOP governor for requiring people to wear a mask in public places	Other	politics
t3_k1f85d	DeSantis won’t answer questions about anything. Where has he been?	Other	politics
t3_k1jbam	Wyoming’s governor has resisted calls for a mask mandate. Now he has the coronavirus.	Other	politics
t3_k1lb55	NY Gov. Cuomo says Supreme Court decision overturning COVID restrictions for religious services has "no practical effect"	Other	politics
t3_k1i5v2	Michelle Obama reflects on how she put her anger aside for a peaceful transition	Other	politics
t3_k1e8tc	A battle over right-wing media bookings is playing out as Fox News reportedly tells guests to not appear on Newsmax	Other	politics
t3_k17cvu	Mnuchin to put $455B in COVID-19 relief funds beyond successor's reach	Other	politics
t3_k1l2es	Stimulus plans sidelined as Georgia Senate runoffs draw focus, says GOP Rep	Other	politics
t3_k1ihqn	Cuomo calls a sheriff who won't enforce mask mandate a 'dictator'	Other	politics
t3_k1fgsz	Supreme Court Blocks Attendance Restrictions Due To COVID-19 In New York	Other	politics
t3_k199ny	Supreme Court rules against NY coronavirus restrictions	Other	politics
t3_k1a1cx	In a 5-4 ruling, Supreme Court sides with religious groups in a dispute over Covid-19 restrictions in New York	Other	politics
t3_k1jm1v	Supreme Court ruling doesn’t have 'any practical effect,' Cuomo says	Other	politics
t3_k1k3w1	Federal prosecutors hold protesters for months pretrial	Other	politics
t3_k1i7x4	Georgia Senator David Perdue boosts wealth with well-timed stock trades	Other	politics
t3_k1orau	US records 2,300 COVID-19 deaths as pandemic rises with holidays	Other	politics
t3_k1p5ej	Thanksgiving Celebrations Could Double U.S. COVID-19 Death Rate to 4,000 a Day, Professor Predicts	Other	politics
t3_k1c7g8	Mocking Rudy Giuliani's Voter Fraud Claims, Elizabeth Warren Insists to Katie Porter That Square Is 'a Circle'	Other	politics
t3_k19equ	Supreme Court relieves religious organizations from some covid-related restrictions	Other	politics
t3_k1mwv5	Amid Public Health and Employment Crises, New Survey Shows Poor Americans Agree on Policy Solutions - People living in poverty across the country support a "bold policy agenda for government to make work pay and ensure that everyone has high-quality, affordable healthcare, housing, and food."	Other	politics
t3_k1mesl	Why now?' Dismay as US considers troop pullout from Somalia	Other	politics
t3_k1fuf4	Florida Gov. Ron DeSantis extends order banning local mask mandates	Other	politics
t3_k1p3e0	Fact check: Videos of shredding truck do not show ‘destruction of voter fraud evidence’ at Cobb County, GA.	Other	politics
t3_k1p7ye	Government Model Suggests U.S. COVID-19 Cases Could Be Approaching 100 Million	Other	politics
t3_k1j5fg	Supreme Court Blocks New York COVID Restrictions on Religious Gatherings | The decision itself is narrow. But it will likely be read as a free pass for churches and synagogues to spread COVID-19 with impunity.	Other	politics
t3_k1mwo7	The Next Administration Should Bring the Shadow Wars into the Light | Lethal tactics and entire campaigns launched urgently after 9/11 have corroded oversight and American standing.	Other	politics
t3_k198hm	Supreme Court blocks strict COVID-19 restrictions on some New York houses of worship	Other	politics
t3_k1bqtr	Supreme Court Says New York Can't Limit Attendance In Houses of Worship Due To COVID	Other	politics
t3_k15ys2	Head of USAID tests positive for coronavirus	Other	politics
t3_k17xoo	Pennsylvania judge orders halt to further vote certification, Gov. Tom Wolf to appeal	Other	politics
t3_k17l93	Mayor of Denver apologizes for holiday travel after advising residents to stay put	Other	politics
t3_k1a5xx	Supreme Court blocks NY from enforcing Covid limits on churches	Other	politics
t3_k19edd	West Virginia's Republican governor blasts mask critics	Other	politics
t3_k1h7if	Deliberately Distorting' Reasoning for Limiting Large Religious Gatherings, SCOTUS Rules Against New York State's Restrictions	Other	politics
t3_k18mrd	N.J. mayor gives up on trying to change people's Thanksgiving plans, "We're realistic that people aren't going to listen"	Other	politics
t3_k1kavi	John James concedes to Peters in Senate race 3 weeks after election	Other	politics
t3_k1a8dz	Coronavirus News: Supreme Court rules against NY COVID restrictions on houses of worship	Other	politics
t3_k1eq6w	The perils of voting: One disqualified voter was Tom Cotton's wife	Other	politics
t3_k1fwmq	Georgia senators call for special session to address voting issues	Other	politics
t3_k1n0ed	Hundreds of Anti-Lockdown Protesters Gather for Thanksgiving Meal at Oregon State Capitol	Other	politics
t3_k1ke0v	Can We Build a Progressive Future If We Dismiss a Large Part of the Working Class?	Other	politics
t3_k15suo	Denver mayor asks city not to travel for Thanksgiving, then heads to Mississippi	Other	politics
t3_k1jhh4	Supreme Court’s conservatives lift Covid restrictions on New York houses of worship	Other	politics
t3_k1q4a0	Julia Louis-Dreyfus spoofs Rudy Giuliani while announcing 'Veep' virtual table read	Other	politics
t3_k1qrws	Kamala Harris calls teen who went viral for painting portrait of vice president-elect	Other	politics
t3_k1fqqx	Supreme court bars Covid attendance limits at New York houses of worship	Other	politics
t3_k1822r	The radical history of the Red Power movement's fight for Native American sovereignty	Other	politics
t3_k1lohv	What hunting Bigfoot taught a Republican congressman about politics	Other	politics
t3_k1mtdw	GOP clashes as deadline to repeal tainted bailout law nears — Hopes of repealing an energy bailout law are in danger at the Ohio Statehouse as Republican lawmakers argue sharply different positions on how and whether to repeal the legislation with only weeks before Ohioans begin to pay the price	Other	politics
t3_k1j1jf	Gov. Hogan: Report that first batch of Covid-19 tests were never used 'completely false'	Other	politics
t3_k1k6sl	California officials plan to relocate thousands of homeless people from hotels	Other	politics
t3_k17gsu	Federal appeals court letter on suit over Georgia election: This court may lack jurisdiction	Other	politics
t3_k1jcfc	Consumer Bureau to Decide Who Owns Your Financial Data. What Should Banks, Fintechs Be Allowed to Do With All that They Know About You?	Other	politics
t3_k1evos	Supreme Court temporarily bars New York from setting church attendance limits	Other	politics
t3_k1gf5j	CTV News: U.S. Supreme Court blocks N.Y. coronavirus limits on houses of worship.	Other	politics
t3_k16sx4	Acting head of USAID tests positive for Covid-19	Other	politics
t3_k1lwrv	Appeals court: City of Cincinnati must pay $168K over 'invalid' trigger activator ban	Other	politics
t3_k1hxk0	Gov. Cuomo: COVID-19 winter plan to be developed after Thanksgiving data	Other	politics
t3_k1f7aj	Rationales shift as Nevada considers future of vote by-mail	Other	politics
t3_k1bvne	Why the U.S. Could Be the Big Loser in the Huge RCEP Trade Deal Between China and 14 Other Countries	Other	politics
t3_k1hcah	U.S. Supreme Court backs religious groups over New York virus curbs	Other	politics
t3_k1dmc9	Paper shredding drives false election claims in Georgia	Other	politics
t3_k182xd	The reason we know it's about to get better	Other	politics
t3_k1ly0y	Santa Clara County joins undocumented immigrant census count lawsuit	Other	politics
t3_k19gcf	Colorado Congresswoman-elect Lauren Boebert may carry Glock at Capitol	Other	politics
t3_k1eifh	Progressives Look to Wield Power in a New Place: The Foreign Affairs Committee	Other	politics
t3_k173r0	China Vows Response Following U.S. Admiral's Trip to Taiwan	Other	politics
t3_k1in6p	A Fight Over Agriculture Secretary Could Decide the Direction of Hunger Policy	Other	politics
t3_k1ia4e	Republican Devin Nunes Compares Democrats to 'Weird Star Wars Freaks'	Other	politics
t3_k1i5sb	The true story behind Thanksgiving is a bloody one, and some people say it's time to cancel the holiday	Other	politics
t3_k1hulv	11 of the most Bizarre Elections in American History	Other	politics
t3_k1h7gb	Covid-19: US Supreme Court backs religious groups over New York caps	Other	politics
t3_k1r593	New York Governor Cuomo called the Supreme Court ruling that blocked some COVID-19 restrictions on religious services 'irrelevant'	Other	politics
t3_jzjwz1	100 Republican national security experts demand GOP admit Trump loss	TS	politics
t3_jzr4dw	Michigan elections board certifies results from presidential election, sealing Biden’s win in state	ER	politics
t3_jzgzo5	Trump is not just refusing to concede, he is sabotaging nation’s interest	TS	politics
t3_jzfuso	Trump team falsely claim he was not assisted in transition by Obama	TS	politics
t3_jzj864	Business Leaders Tell GOP: Start Biden Transition or No Money for Georgia Senate Run-Offs	T	politics
t3_jzka2y	Pro-Trump Attorney Urges Republicans Not to Vote in Georgia Runoff	O	politics
t3_jzb2zh	Twitter Afire After Trump Camp Breaks With Lawyer: Lasted ‘About Half A Scaramucci’ | “Sidney Powell should refuse to concede her position from Trump’s legal team,” one critic joked.	TS	politics
t3_jz8bvm	Native American voters across Minnesota turned out to oust Trump - Vote totals were up around Red Lake, and 90% for Biden	ER	politics
t3_jzmb5h	Detroit had more vote errors in 2016 when Trump won Michigan by a narrow margin. He didn’t object then.	ER	politics
t3_jziz6f	Trump will leave office soon. But we can’t let him escape accountability for his misdeeds.	TS	politics
t3_jzg091	Biden is stealing the spotlight. Trump can't stand it.	O	politics
t3_jzmvi7	Trump's on his way out, but leaves a lasting legacy: The right's open embrace of terrorism. How did the Kenosha shooter post $2 million in bail? Because conservatives are normalizing right-wing terrorism	TS	politics
t3_jzeymy	New Zealand PM offers COVID-19 help to U.S. President-elect Biden	BP	politics
t3_jzbb0y	Reporter Carl Bernstein names 21 GOP senators who 'repeatedly expressed extreme contempt for Trump'	TS	politics
t3_jze8d0	Transition warning: Trump's mental illness is a growing danger	TS	politics
t3_jzo4ys	To Prevent 'Active Sabotage' of His Agenda, Biden Urged to Clean House of Trump Loyalists on Day One	BP	politics
t3_jzgz98	John Kasich Stunned GOP Isn’t Defending Democracy Against Trump	TS	politics
t3_jzicmc	How Ronald Reagan’s Racism Helped Pave the Way for Donald Trump’s	O	politics
t3_jzos3p	It’s Time To Consider Sanctions for Trump’s Legal Team	TS	politics
t3_jzj8y9	Republican pollster: Trump's false 'rigged' election claims may hurt GOP chances of keeping Senate	EF	politics
t3_jznq3n	Clip of Ted Cruz Saying Democrats Would Say COVID 'Magically Better' Week After Biden Wins Resurfaces	O	politics
t3_jzonsl	Former Defense Secretary Jim Mattis says Biden should toss all of Trump's 'America First' policies	BP	politics
t3_jzm9x0	Biden picks John Kerry for climate envoy on national security council	BP	politics
t3_jzgode	Trump axed campaign lawyer Sidney Powell was because 'she was too conspiratorial even for him'	TP	politics
t3_jztvos	Megathread: The GSA Has Informed President-Elect Joe Biden that the Administration is Ready to Begin the Formal Transition Process	T	politics
t3_jzh7ew	Carl Bernstein names 21 Republican senators who have ‘privately’ expressed ‘extreme contempt’ for Trump	TS	politics
t3_jzkjrv	Biden team is reportedly pushing congressional Democrats to strike an immediate stimulus deal with Republicans to stave off renewed recession	BP	politics
t3_jz9j48	Kasich: Republicans 'either in complete lockstep' or 'afraid' of Trump	O	politics
t3_jzpeei	Trump Is Blowing Up the Georgia GOP—and It Couldn’t Happen at a Better Time	TS	politics
t3_jzhuwc	New Zealand offers Biden tips on COVID-19 after successful response	BP	politics
t3_jzmtno	Tucker Carlson was attacked by Trump supporters for questioning the outlandish claims of the president's lawyer Sidney Powell before she was fired	TS	politics
t3_jzj73m	Trump’s press secretary Kayleigh McEnany heckled in briefing: ‘When will you admit you lost?’	TS	politics
t3_jzlc67	GOP Sen. Rob Portman says Biden transition funds should be released	T	politics
t3_jzlnvy	A major Trump donor’s company got a 3 percent government-backed pandemic loan. It sells title loans at a 350 percent annual rate.	TS	politics
t3_jzhcb0	What if Trump never concedes? The Constitution will end his term, conservative lawyer John Yoo says	T	politics
t3_jzmfmo	President Trump Wanted a Supreme Court Election Battle. His Current Appeal Simply Cannot Get Him There.	EF	politics
t3_jzguka	Trump handing Taliban a victory on his way out, says former national security adviser H.R McMaster	TP	politics
t3_jzgsx3	Trump legal team says Sidney Powell had no formal role, but record shows they loved her involvement	TS	politics
t3_jzba0d	Carl Bernstein names 21 GOP senators who 'privately expressed their disdain' for Trump	TS	politics
t3_jzj1p6	Group of Black voters in Detroit suing President Trump, citing voting rights abuses &amp; disenfranchisement	EF	politics
t3_jzpowr	Let’s hear it for the judges for dismissing Trump’s lawsuits	EF	politics
t3_jzlqyf	GOP senator says Biden's vote lead 'has not changed,' urges country to 'move forward'	T	politics
t3_jzjoc9	Republican former national security officials urge party to demand Trump concession	T	politics
t3_jz8td4	Here are the 3 legal cases Trump may have to face once he’s no longer president	TS	politics
t3_jzpllg	The Already Useless Trump Kids Are About to Get Even More So	O	politics
t3_jzcmj4	New Zealand leader Ardern offers virus know-how to Joe Biden | New Zealand Prime Minister Jacinda Ardern has become the latest world leader to congratulate President-elect Joe Biden on his election victory, saying she offered to share her nation’s expertise on dealing the coronavirus	BP	politics
t3_jz9k6j	Donald Trump’s legal team has been a ‘national embarrassment,’ according to one loyal Trump supporter	TS	politics
t3_jzis32	Carl Bernstein named 21 GOP senators who he said are enabling Trump's attempts to subvert US democracy by only criticizing him in private	TS	politics
t3_jzny0i	Pennsylvania Republicans Voted Against Certifying Vote in County Trump Won by 22,000	ER	politics
t3_jzmam7	Trump's top election lawyer in Wisconsin says he and his wife voted illegally in the campaign's latest legal argument	EF	politics
t3_jzpy16	On Trump, GOP's silence 'can't be excused and won't be forgiven' — For the first time, a corrupt US leader is trying to cling to power through autocratic means. Let history note who lacked the patriotism to speak up.	TS	politics
t3_jzpvbh	Rush Limbaugh criticizes Trump legal team for promising 'bombshells' and failing to deliver	TS	politics
t3_jzmqas	Conservatives spread false claim Biden invented 'office' of the president-elect	TS	politics
t3_jzg8x4	Elite Strike Force'? Trump Legal Team Throws Right-Wing Attorney Sidney Powell Under the Bus as Coup Attempt Flails	TS	politics
t3_jz9qp2	Haaland being vetted by Biden team for Interior secretary	BP	politics
t3_jzej98	Pennsylvania’s Lt. Gov. Trolls Trump, ‘Dopey’ GOP Lawsuits In Epic Tweetstorm	EF	politics
t3_jzfpdr	Donald Trump has assaulted our democracy	TS	politics
t3_jzq2dw	Poll: Majority say Trump should concede	ER	politics
t3_jzk7yg	A Federal Judge Rejected Trump's Ludicrous Pennsylvania Case With Pure Disdain	EF	politics
t3_jzla7n	Michigan voters sue Trump for allegedly disenfranchising Black voters with election interference	EF	politics
t3_jzeqq0	Opinion | Why Biden should stop parsing words and call Trump's lies a coup	TS	politics
t3_jzj1yp	Major business leaders reportedly signed a letter urging Trump to concede, and warn that 'our democracy grows weaker' the longer the presidential transition is delayed	T	politics
t3_jzd94c	Carl Bernstein Names Names: 21 GOP Senators Who've Privately Ripped Trump	TS	politics
t3_jzmus9	Donald Trump’s Bid to Steal the Election Hinges on a Shameless Homophobe Who Once Called Him a Lying, Idiotic Bully	EF	politics
t3_jzis4d	Will Trump’s Accusers Finally Get Their Day In Court? | He soon will be unable to hide from the women suing him for defamation.	TS	politics
t3_jz9yit	Representative Ilhan Omar: ‘I Hope President Biden Seizes This Opportunity’ — The president-elect has a once-in-a-generation opportunity to reorient US foreign policy so this country truly means what it says.	BP	politics
t3_jzhsuf	Trump urges state legislatures and courts to ‘flip’ results	EF	politics
t3_jzrwc2	Pennsylvania Supreme Court Kills Trump Bid to Disqualify Ballots	EF	politics
t3_jzjbng	In Another Country This Would Be Called a Coup: Detroit NAACP Head on Trump Trying to Overturn Vote	EF	politics
t3_jz8dam	Biden Chooses Antony Blinken, Defender of Global Alliances, as Secretary of State	BP	politics
t3_jziqei	Team Trump Fired QAnon Lawyer Sidney Powell But She's Tweeting Through It - Last week she was part of Trump's "elite strike force." Now she's "practicing law on her own."	TS	politics
t3_jzlbdp	Trump friend and adviser Steve Schwarzman recognizes Biden as President-elect	T	politics
t3_jzqf5t	Republican Congressman Says GOP 'Embarrassing,' Calls on Party to 'Denounce' Trump's 'Conspiracy Theories'	TS	politics
t3_jzc781	John Kasich calls Trump's refusal to concede 'absurd'	TS	politics
t3_jzji16	Trump's closest business ally just admitted that the president lost the election	ER	politics
t3_jzlipn	Sidney Powell Stricken from Trump’s ‘Elite Strike Force’ Legal Team 8 Days After President Called Her ‘Wonderful’	TS	politics
t3_jzc3y4	More Republicans are losing patience with Trump's legal absurdities	TS	politics
t3_jzdr2f	Voting machines manufacturer on Trump conspiracy theory: ‘It’s not physically possible’	EF	politics
t3_jzm28z	Biden to nominate first Latino and immigrant to run Homeland Security	BP	politics
t3_jzskav	Pennsylvania Supreme Court Reverses One of Trump’s Only Post-Election Litigation Wins	EF	politics
t3_jzebvu	Trump’s fundraising emails give spam a bad name - The election is over, but Trump's campaign is still bombarding his supporters with conspiracy-mongering demands for more money. Its exhausting.	TS	politics
t3_jzfnsj	Biden to spotlight CDC officials shunned by Trump	BP	politics
t3_jz9obr	US election 2020: Trump ally urges him to accept defeat in US vote	ER	politics
t3_jzjl2a	Republican national security experts call on Trump to concede, begin transition	T	politics
t3_jzazcu	Maryland governor says Trump should concede election, stop golfing	T	politics
t3_jzs0fi	Michigan Certifies Joe Biden's Election Victory	ER	politics
t3_jzrmc0	Trump’s Ridiculous, Sloppy Coup Attempt Just Face-Planted in Michigan	EF	politics
t3_jzsk0y	Congress Has Every Right to Keep Investigating Trump After He’s Gone	TS	politics
t3_jzrlc7	Maine certifies Biden’s victory in the state’s election	ER	politics
t3_jzqg3e	Trump campaign suffers new court loss in attempt to block Biden’s win in Pennsylvania	EF	politics
t3_jzsjjw	Over 100 CEOs threaten to cut off funds to Georgia GOP if Trump keeps blocking transition: report	T	politics
t3_jz8ss3	Trump May Announce His 2024 Bid Before Year’s End	TP	politics
t3_jzs4qi	Detroit had more vote errors in 2016 when Trump won Michigan by a narrow margin. He didn’t object then.	ER	politics
t3_jzqk4b	Secret Service members asked about protecting soon-to-be-former president Trump full time in Florida: Sources | Agents in Trump's detail have been asked about relocating to West Palm Beach.	T	politics
t3_jzn0c8	Biden taps John Kerry as Special Presidential Envoy for Climate, marking the first time the NSC will have an official dedicated to climate change	BP	politics
t3_jzfpm4	Trump set on veto of defense bill over renaming bases honoring Confederates	BP	politics
t3_jz9j4j	Trump legal team shuns Sidney Powell as insiders and national security officials see no evidence supporting her voting machine claims	EF	politics
t3_jzfulz	Republicans as a multicultural working class party? That's Trump-level delusional thinking.	TS	politics
t3_jz8wcb	Dominion rep responds to Trump campaign claims in Fox News interview: 'Physically impossible' to switch votes	EF	politics
t3_jzaoie	In last-ditch bid to stay in office, Trump deploys his favorite tactics to bully and intimidate	TS	politics
t3_jzsjpm	Trump is reportedly worried that his legal team is made up of 'fools that are making him look bad'	TS	politics
t3_jzkuz6	Trump Faces Growing Calls From Biz Leaders To Concede After Legal Battles Fall Flat	T	politics
t3_jzqzld	Trump campaign forces Georgia taxpayers to pay for second recount after first one confirms its loss. A hand recount of nearly 5 million votes confirmed Biden's win, but Team Trump wants to milk taxpayers even more	EF	politics
t3_jzsr22	Michigan certifies election results, making Biden's win official	ER	politics
t3_jzhlu7	Trump's 'elite, strike force' legal team starts to shrink	TS	politics
t3_jzr5yp	Michigan Certifies Joe Biden's Election Victory	ER	politics
t3_jzorhc	Trump fears Giuliani, other lawyers in Biden vote challenge are ‘fools that are making him look bad’	TS	politics
t3_jztm0i	Trump Campaign’s Actual Argument in Appeals Court: We’re Only Trying to Disenfranchise 1.5 Million Voters, Not 6 Million Pennsylvanians	EF	politics
t3_jzobu4	Behind the scenes, Trump frustrated with his legal team's maneuvers	TS	politics
t3_jzlcxd	Trump Could Push Don Jr. and Ivanka in 2024, but Trumpism Is a Hard Sell Without Him	TP	politics
t3_jzmeyu	New report details Trump effort to seize thousands of acres of private land for border wall	TP	politics
t3_jzozd1	Why the Trump campaign’s big legal flameout in Pennsylvania seems like a turning point, even for Republicans	ER	politics
t3_jza1rz	Trump campaign cuts ties with attorney Sidney Powell after bizarre election fraud claims	EF	politics
t3_jzrye4	Michigan votes to certify Biden's win over Trump	ER	politics
t3_jzofom	Biden moves forward as GOP breaks with Trump rise	T	politics
t3_jzcjw9	Twitter, Facebook will hand official accounts over to Biden administration	T	politics
t3_jziwyr	What if Trump won’t leave the White House? A hostage negotiator, an animal-control officer, and a toddler whisperer have advice	T	politics
t3_jzo44d	Two years ago this week Trump was mocking a turkey for refusing to concede an election	T	politics
t3_jzc0q0	Trump’s lonely G-20 marks a fitting end	TS	politics
t3_jzquzq	GOP senator: No indication of widespread voting irregularities, window for Trump challenges is 'closing'	EF	politics
t3_jzk79i	Former GOP Ohio Governor Says Republicans Are Either ‘Afraid’ or ‘in Complete Lockstep’ With Trump	TS	politics
t3_jzpbvs	Biden chooses former Fed Chair Janet Yellen to be Treasury secretary, report says	BP	politics
t3_jzfcif	Trump Is Running Out Of Time As Key States Set To Certify That Biden Won	ER	politics
t3_jzbggz	The Motley Crew Leading Trump’s Election Challenges | Jared Kushner wanted a “James Baker-like” figure, but he ended up with a ragtag bunch of lawyers led by a raving Rudolph Giuliani, who made his first appearance in federal court in this century.	EF	politics
t3_jzlzl3	After looming so large in Washington, Donald Trump has shrunk into a small, petty man	TS	politics
t3_jzprxe	Trump’s Absurd ‘You Did It First’ Argument for Stealing the Election	EF	politics
t3_jztjh2	National Embarrassment Donald Trump Worried Lawyers Are Sullying His Pristine Reputation	TS	politics
t3_jzntq8	GM flips to California’s side in emissions lawsuit against Trump admin	TP	politics
t3_jzs06l	Michigan certifies Joe Biden's win despite Trump's GOP overtures | The Board of State Canvassers, which has two Republicans and two Democrats, confirmed the results on a 3-0 vote with one abstention	ER	politics
t3_jzsruy	Rush Limbaugh Does Full 180, Blasts Sidney Powell After Team Trump Disavowed Her	TS	politics
t3_jzhzmd	Reporter Carl Bernstein names 21 GOP senators who 'repeatedly expressed extreme contempt for Trump'	TS	politics
t3_jzr5f1	Michigan Election Board Certifies Victory for Biden	ER	politics
t3_jzk32t	Biden Backs Democrats’ Pursuit Of Bigger COVID-19 Relief Deal	BP	politics
t3_jziow1	Facebook will give presidential accounts to Biden even if Trump refuses to concede election	T	politics
t3_jzcq86	As Biden marches forward with Cabinet, Trump hopes likely to fade in key states	T	politics
t3_jzp967	General Motors Aligns With Biden, Pulls Out of Lawsuit Supporting Trump	TS	politics
t3_jz8ywc	Trump campaign legal team distances itself from Powell	TS	politics
t3_jztlp5	G.M. Drops Its Support for Trump Climate Rollbacks and Aligns With Biden	TS	politics
t3_jzidnq	A diplomatic powerhouse': Biden will nominate Linda Thomas-Greenfield as UN ambassador, reports say	BP	politics
t3_jzaxgb	Trump campaign files narrow appeal in Pennsylvania - It is seeking permission to reframe its argument again.	EF	politics
t3_jz95se	Reports: Biden to name long-time confidant Antony Blinken as Secretary of State	BP	politics
t3_jzphue	GOP senator, business leaders urge prompt Biden transition	T	politics
t3_jzb3ya	Trump campaign cuts ties with attorney Sidney Powell after bizarre election fraud claims | US news	EF	politics
t3_jzrnx5	Michigan certifies Biden victory in another blow to Trump	ER	politics
t3_jzgh8i	Antony Blinken: Biden's secretary of state nominee is sharp break with Trump era	BP	politics
t3_jzp2ts	Joe Biden nominates first woman to lead intelligence and first Latino to head homeland security	BP	politics
t3_jzoam2	Reality Forecloses on the Trump Presidency | A fading campaign collapses under the weight of finally having to back up big talk with actual substance.	TS	politics
t3_jzjyaw	Trump EPA removes tool states use to protect farmworkers, environment	TP	politics
t3_jzg3aa	Biden expected to pick longtime diplomat Linda Thomas-Greenfield as U.S. ambassador to U.N.	BP	politics
t3_jzr88b	Michigan election board certifies 154,000-vote victory for Joe Biden, another setback in Trump’s effort to overturn election results	ER	politics
t3_jzrzv8	Rush Limbaugh Knocks Trump's Lawyers For Not Providing Voter Fraud Proof	EF	politics
t3_jz8l93	Top Biden adviser seen as making tech regulation more likely	BP	politics
t3_jzsna1	King of Jordan becomes first Arab leader to speak with President-elect Biden	T	politics
t3_jzi67y	More Republicans acknowledge Biden's victory, as two key states set to certify election results	ER	politics
t3_jzn3cr	Biden Taps John Kerry For New National Security Role Focused On The Climate Crisis	BP	politics
t3_jzm6f8	Carl Bernstein names 21 GOP senators who privately express “contempt” for Trump but still enable him	TS	politics
t3_jzsfv2	Obama calls Trump era an 'anomaly' in Canada-U.S. relations	O	politics
t3_jzu2rx	Michigan Certifies Election Results, Declaring Biden Winner In New Blow To Trump	ER	politics
t3_jztkzj	Trump fears Giuliani, other lawyers in Biden vote challenge are 'fools that are making him look bad'	EF	politics
t3_jzmemb	Trump Lawyer Tries To Toss Out His Own Vote In Wisconsin Recount	EF	politics
t3_jzfp15	Trump’s Anti-LGBTQ Agenda Has Been Hidden in Plain Sight	TP	politics
t3_jzreko	Michigan's state board certifies Biden's win	ER	politics
t3_jzn4mo	Despite Trump’s prod, Mich. to consider certifying Biden win	ER	politics
t3_jzst4r	Trump fears Giuliani, other lawyers in Biden vote challenge are 'fools that are making him look bad'	EF	politics
t3_k07ocv	US election: Biden becomes first-ever presidential candidate to receive 80 million votes	ER	politics
t3_k08ewo	Brennan takes final shot at Trump: 'I leave his fate to our judicial system, his infamy to history, &amp; his legacy to a trash heap'	TS	politics
t3_k07nxi	Pennsylvania certifies Biden's victory	ER	politics
t3_k028s9	Roger Stone-Tied Group Threatens GOP: If Trump Goes Down, So Does Your Senate Majority	ER	politics
t3_k08slh	On Night of Ginsburg’s Death, McConnell Pushed Trump to Nominate Amy Coney Barrett	TP	politics
t3_jzvxxd	Trump campaign loses 5 more cases in Pennsylvania Supreme Court decision	EF	politics
t3_k055sr	Republicans sold out democracy to appease Trump's loser tantrum	TS	politics
t3_k07sfh	It Actually Was a Landslide: 80 Million Votes and Counting For Biden; The “red mirage” has vanished to reveal a blue mandate for President-Elect Joe Biden	ER	politics
t3_k0az01	Biden accuses Trump of ‘outright cruelty’ at the border as he introduces Homeland Security pick	TP	politics
t3_k06l7z	Yes, the Biden administration should hold Trump accountable	BP	politics
t3_jzuvas	Report of a 'souring' relationship between Trump and Giuliani	TS	politics
t3_k05kkv	Every Day Trump Repeatedly Emails His Supporters a Dangerous Message: Democracy Doesn’t Work. Be outraged, don’t accept the election results…and send money.	ER	politics
t3_k02n7d	Should Trump Be Prosecuted?	TS	politics
t3_jzv0k7	Politicizing masks ‘is like politicizing toilet paper,’ Biden coronavirus adviser says	O	politics
t3_k047z0	Press: Trump's biggest fear is — lock him up	TS	politics
t3_jzx12o	Here Come the Adults | Biden’s Cabinet is shaping up to be everything that Trump’s was not.	BP	politics
t3_jzyvdn	Lindsey Graham calls Biden, Pelosi and Schumer "trifecta from hell," says they'll end Electoral College	BS	politics
t3_jzvqda	Trump Lawyer Appears on Fox Touting ‘Promising’ Case in Pennsylvania After It’s Thrown Out by Judge	EF	politics
t3_k03h7b	Trump Push To Invalidate Votes In Heavily Black Cities Alarms Civil Rights Groups	EF	politics
t3_k02ya3	Rachel Maddow Rings The Alarm On How Trump's 'Setting The Place On Fire' As He Leaves	T	politics
t3_k05npo	Trump Is Still President, Even Though He’s Not Acting Like One | The federal government has essentially stopped functioning as a federal government.	TS	politics
t3_jzv6i4	‘Bye bye Trump’: Ilhan Omar and others celebrate as president finally begins transition	T	politics
t3_k05r0v	Enough cowardice: Democrats must forge ahead, without caring what the Trumpers say	T	politics
t3_jzwk4e	The Secret Service is reportedly preparing for Trump's 'post-presidency life'	T	politics
t3_jzuphz	Trump goes out with a whimper and a tweet. It was always going to be that way	T	politics
t3_k07u24	Pennsylvania governor: Democrat Joe Biden certified as winner of presidential election in state	ER	politics
t3_jzw3ni	75 Percent Of Lawyers Say They Wouldn’t Support Their Firm If They Represented Donald Trump — Lawyers do *not* approve of what Jones Day's doing.	O	politics
t3_k0bsrn	Ivanka Trump called out for boasting about drop in greenhouse emissions: "This is largely because of the pandemic"	O	politics
t3_k03r9y	‘A passing attempt at adulthood’: Stacey Abrams gives scathing reaction to Trump finally starting transition	T	politics
t3_k04x2c	Cannabis stocks surge after Trump administration sets formal transition in motion	T	politics
t3_k03hse	Trump campaign loses 5 more election cases in Pennsylvania	EF	politics
t3_k08z5i	President-Elect Joe Biden Clinches Presidency—Again—as Pennsylvania Certifies Election Results	ER	politics
t3_jzvf9k	Dr. Redlener: Trump’s denial of science has ‘poisoned’ this country	O	politics
t3_k09ns0	Pennsylvania, Nevada certify Biden as winner of presidential vote	ER	politics
t3_jzyoyz	Laura Ingraham Admits It’s Over for Trump: ‘Biden Will Be Inaugurated’	T	politics
t3_k0dtv5	White House has signed off on Joe Biden getting the President's Daily Brief	T	politics
t3_k0cdoc	Trump ignores reporter’s question about trying to pardon himself after doing so for turkey	TS	politics
t3_k033f1	Republican official: Trump efforts to undermine Georgia results could 'suppress the vote' in U.S. Senate runoff elections	EF	politics
t3_k05u50	Glum Laura Ingraham Tells Fox Viewers It’s Done: ‘I’d Be Lying’ If I Said Trump Still Had A Chance	O	politics
t3_k04a0b	Rush Limbaugh Criticizes Trump Campaign for Hyping Up 'Blockbuster' Voter Fraud Evidence: 'Nothing Happened… Not Good'	EF	politics
t3_k06g46	Shameful and Concerning He Is Even Being Considered,' Says AOC as Rahm Emanuel Floated for Role in Biden Cabinet	BP	politics
t3_k06bmj	Trump Mocked After Telling GOP to Listen to Randy Quaid's Election Demand	TS	politics
t3_jzy84b	Midtown Trump Tower To Have Reduced Security After President Leaves Office in January	T	politics
t3_jzx73a	Trump's effort to steal the election is done	EF	politics
t3_k03iou	In Break From Trump, Biden Opts for Experience, Expertise for Top National Security Jobs	BP	politics
t3_k09n7r	Nevada Supreme Court certifies Joe Biden's win in Nevada, making his win in the battleground state official	ER	politics
t3_k05ixh	2 in 3 say coronavirus relief should be Biden's top priority in first 100 days: poll	O	politics
t3_jzvrkx	Trump came in promising so much winning. He’s going out with so much whining.	T	politics
t3_k04vzj	Trump’s dam finally breaks. But we cannot go through this again.	O	politics
t3_k00ahk	Trump says he ‘will never concede’ and transition process has nothing to do with election result	T	politics
t3_k06pds	Fox News' Laura Ingraham and Tucker Carlson distance themselves from Trump	TS	politics
t3_k04qk9	Jon Ossoff Tries to Drive Wedge Between Georgia Trump Voters, GOP Senate Candidates Over Biden Win	ER	politics
t3_k0942q	Melania Trump wanted to light the White House with rainbow colors for Pride month. She got told no.	TP	politics
t3_k0d1g3	Well That Was Weird as Sh*t': As More States Certify His Defeat, Trump Holds 60-Second Briefing to Brag About Stock Market	ER	politics
t3_k0ahv4	Judge Emmet Sullivan Will Oversee Voting Rights Act Case Accusing Trump of Anti-Black Campaign to Overturn Election	EF	politics
t3_k07q55	Joe Biden crosses 80 million votes, 10 million more than Obama got	ER	politics
t3_k0azls	Trump’s Enablers Are Sabotaging the Georgia Senate Runoff Election–and Helping Democrats. There’s a weird, right-wing push to boycott January’s pivotal U.S. Senate runoffs. Is Trump angry enough to join it?	ER	politics
t3_k03zxy	The EU thanks Joe Biden for his 'clear support' in Brexit dispute with the UK	BP	politics
t3_k05ep2	Surgeon General Issues ‘Dire’ COVID-19 Warning As Trump White House Plans Indoor Parties	O	politics
t3_k08659	Pennsylvania certifies Biden victory	ER	politics
t3_k0ammd	Nevada Supreme Court Certifies Biden’s Victory Over Trump	ER	politics
t3_k0c5mr	Paul Ryan calls for Trump to accept results: 'The election is over'	ER	politics
t3_k04620	Beyond an embarrassment,' legal experts say of Trump and Giuliani's floundering efforts in court	EF	politics
t3_k07zev	Computer repairman who claimed he gave Hunter Biden data to Giuliani closes shop as laptop saga gets stranger	BS	politics
t3_k0a761	Trump brags about Dow 30,000 at surprise press conference, leaves after a minute	TP	politics
t3_k09pwl	Atlanta Hawks Arena, Which Played Huge Role in Biden Winning Georgia, to be Used Again for Senate Runoffs	ER	politics
t3_k0djl7	Trump Insists He’s Still Going to Be President as White House Landlord Asks For Forwarding Address for Security Deposit	T	politics
t3_jzzepz	Trump dismantles decades-old surveillance treaty irreparably on his way out the door	TP	politics
t3_k07jm6	Column: Trump lost and his lawsuits are garbage. But please keep donating! The grift must go on.	EF	politics
t3_jzyzyc	Should Joe Biden cancel billions in student loan debt?	BP	politics
t3_k08kqr	Pennsylvania just certified its presidential election results, officially declaring Joe Biden the winner	ER	politics
t3_k0dyrm	The Republican Party Is Dead. It’s the Trump Cult Now.	TS	politics
t3_k0a31m	Biden-Harris ticket the first in US history to surpass 80 million votes	ER	politics
t3_k02329	Revealed: Trump Officials Rush to Mine Desert Haven Native Tribes Consider Holy	TS	politics
t3_jzwb0o	Sidney Powell Undermined Georgia GOP During Crucial Senate Runoff Before Trump Campaign Cut Her Loose	TS	politics
t3_jzvx08	NYPD planning to reduce police presence, congestion around Trump Tower: Sources tell ABC News	T	politics
t3_jzy6dc	Biden Supporters In Pennsylvania Look Ahead To A 'Traditional Presidency'	T	politics
t3_k0ala4	Trump Turns to Randy Quaid for Guidance in Overthrowing Democracy	EF	politics
t3_k08xyk	Democrats didn't refuse to acknowledge Trump’s 2016 victory	T	politics
t3_k0dwtt	75% of every donation to Trump's leadership PAC could actually be spent by the president himself on things like paying family members or financing a 2024 bid	TS	politics
t3_jzvxtn	It’s time Republicans put country over Trump’s injured ego	TS	politics
t3_k0f7jr	Biden unveils a national security team without grifters, trolls or fanatics	BP	politics
t3_k08q8s	Joe Biden Certified As Winner Of Presidential Election In Pennsylvania	ER	politics
t3_k0coc2	Trump is junking a treaty - and two planes - designed to stop nuclear war	TP	politics
t3_k060rf	Laura Ingraham says that Biden will be president: ‘This constitutes living in reality’	T	politics
t3_jzx3px	Trump probably won’t be the last politician to reject an election outcome without evidence	EF	politics
t3_k0feo8	Georgia Republican Voters Consider Boycott Of Special Senate Election In Support Of Trump	ER	politics
t3_k04nof	Biden prioritizes climate crisis by naming John Kerry special envoy	BP	politics
t3_k09pft	Pennsylvania Supreme Court rejects Trump campaign's effort to block counting certain absentee ballots	EF	politics
t3_k0eshp	Trump Appointee Unconstitutionally Interfered With VOA, Judge Rules	TS	politics
t3_k06dr2	No, It Wasn’t a Coup Attempt. It Was Another Trump Money Scam.	EF	politics
t3_k0beyi	Donald Trump stands up for the Confederacy one last time	TP	politics
t3_jzwgzq	Rush Limbaugh, Michigan, GSA hammer nails into coffin of Trump's election fraud claims	EF	politics
t3_jzwrvx	NYT reporter Maggie Haberman thinks Trump's tweet is 'the closest to a concession' he'll give	T	politics
t3_k08fht	Rubio Receives Swift Dunking For Poor Attempt At Painting Biden As An Elitist	TS	politics
t3_k061wu	Republicans With Any Love of Country Must Acknowledge That Trump Has Lost	T	politics
t3_k0359b	It's over for Trump	T	politics
t3_jzvflg	Pennsylvania counties certify election results despite isolated pushback and baseless fraud claims from Trump allies	ER	politics
t3_k0e2uk	Donald Trump's Destruction Of Documents	TS	politics
t3_jzx7gy	Rush Limbaugh knocks Trump's legal team: They promised 'bombshells' at press conference and 'nothing happened'	EF	politics
t3_jzuuec	Biden team wants to understand Trump effort to 'hollow out government agencies'	TP	politics
t3_k0dncv	Marco Rubio Gets Ripped For Criticizing Biden’s ‘Ivy League’ Foreign Policy Team	TS	politics
t3_k00iks	Trump Dismantles Decades-Old Surveillance Treaty Irreparably On His Way Out The Door | Rachel Maddow	TP	politics
t3_k0bfgp	Trump shares bizarre videos and tweets by actor Randy Quaid about voter fraud, Fox News	EF	politics
t3_k0axma	Biden win over Trump in Nevada made official by court	ER	politics
t3_jzvdc2	An OAN Host Has Been Helping Rudy With Trump’s Legal Efforts	EF	politics
t3_k0d4sz	Canvassing board certifies Joe Biden's win in New Mexico	ER	politics
t3_k09adn	Pennsylvania finalizes U.S. election results for Biden: governor	ER	politics
t3_k08hk3	America survived Trump's coup attempt. The media needs to be clear about why.	EF	politics
t3_jzyror	Federal judge calls Trump suit argued by Rudy Giuliani "Frankenstein's Monster" and dismisses case	EF	politics
t3_k034z9	The Trump administration may privatize Fannie Mae and Freddie Mac — and it could disrupt the nation’s housing-finance system	TP	politics
t3_k0dmkk	State board certifies Joe Biden as winner in Minnesota	ER	politics
t3_k0as5g	Judge rebukes another frivolous Trump lawsuit, allowing Pennsylvania to certify results	EF	politics
t3_k0c4gk	Gov. Doug Ducey: 'Joe Biden did win Arizona'	ER	politics
t3_k0f9d4	Well that was weird as s***': Reporters caught on hot mic baffled by Trump's minute long press conference | The president previously warned voters that the stock market would tank if Joe Biden won the election	TP	politics
t3_k07b93	Donald Trump Is Now Retweeting Randy Quaid’s Election Rants And Do-Over Calls	EF	politics
t3_k07txz	Pennsylvania certifies Biden as winner of presidential vote	ER	politics
t3_k024k0	Biden says the Trump White House won't give him COVID stockpile information. Here it is.	TS	politics
t3_k0a3tb	Trump shares Randy Quaid video: 'Fox is dead to me'	O	politics
t3_k0afvh	Ducey acknowledges Biden victory in Arizona for 1st time	ER	politics
t3_k08vm4	Pennsylvania certifies Biden’s victory as battlegrounds make 2020 results official	ER	politics
t3_k081o8	Pennsylvania certifies results of 2020 presidential election, giving Biden the win	ER	politics
t3_k0c01b	How Trump’s conspiracy theories have inspired some supporters to boycott the Georgia runoffs	O	politics
t3_k07fhk	Janet Yellen Is Probably the Best Treasury Secretary We Could Expect from a Biden Presidency	BP	politics
t3_k05ze0	Biden cabinet: Janet Yellen set to become first female treasury secretary	BP	politics
t3_k045ov	Taiwan says is having 'good interactions' with Biden team	BP	politics
t3_k0bpfr	Two more parting shots from Trump aimed squarely at disabled workers	TP	politics
t3_k01a73	After Chaotic 4 Years, Wall St. Is Itching to Unfollow @realDonaldTrump - President Trump turned his Twitter feed into a singular source of market volatility. Now, investors are looking forward to markets free of presidential tweets.	TP	politics
t3_k0d8w9	AOC and Ilhan Omar want to block Biden’s former chief of staff	BP	politics
t3_k041rg	Europe hopes for reset, end to ‘damage control’ under Biden	BP	politics
t3_k0d7kj	Trump administration wants to cut food stamps to thousands of seniors, lawmakers say	TP	politics
t3_k0abt3	President-elect Biden Announces Foreign Policy and National Security Posts	BP	politics
t3_k01f68	Watch Laura Ingraham Finally Tell Fox News Viewers That Biden Beat Trump	ER	politics
t3_k0bb2x	Trump’s QAnon Lawyer Inspired Even More George Soros Disinformation	TS	politics
t3_jzwige	PA Supreme Court rejects Trump challenge to absentee ballots in Allegheny County	EF	politics
t3_k0ftlb	McConnell pushed Trump to nominate Coney Barrett on the night of Ginsburg's death: report	TP	politics
t3_k0f0zp	Watch Trump's Stock Market Collapse Prediction Go Down in Flames	TP	politics
t3_k03ye7	Immigration Advocates Push Biden to Not Just Bring Back DACA But Expand It	BP	politics
t3_k0c42y	Biden win over Trump in Nevada made official by court	ER	politics
t3_jzvws9	Trump previewed his legal strategy 2 years ago, when he said a turkey 'refused to concede and demanded a recount'	EF	politics
t3_k0g41t	YouTube suspends One America News, a Trump favorite, for peddling pandemic misinformation	TS	politics
t3_k09m8g	Pennsylvania certifies election results for Biden	ER	politics
t3_k0allo	Pennsylvania certifies election results, sealing state victory for Biden	ER	politics
t3_k080lt	Pennsylvania certifies Biden as winner of presidential vote	ER	politics
t3_k0e454	Paul Ryan calls on Trump to concede and end lawsuits	T	politics
t3_k083ym	Pennsylvania Certifies Biden as Winner, Driving Stake in Trump’s Legal Effort	ER	politics
t3_k0e1h9	Biden-Harris ticket surpasses 80 million votes: new record	ER	politics
t3_k039s1	Biden Puts White House on Climate War Footing	BP	politics
t3_k0dlh2	Trump's DOJ Backs Down on Deporting Women Alleging ICE Gynecological Abuse	TP	politics
t3_k08kqp	The Damage Is the Point | Trump may not be able to extend his reign, but he can aid and abet his party by further curtailing the right to vote.	EF	politics
t3_k07khz	Kremlin and Putin will not recognise president-elect Biden despite Trump announcement	T	politics
t3_k0ezft	Biden to begin receiving classified Presidential Daily Briefings	T	politics
t3_k05ynk	Fox's Laura Ingraham says Biden will be inaugurated: 'This constitutes living in reality'	T	politics
t3_k0db7w	Biden picks Alejandro Mayorkas, a son of Jewish Cuban refugees, to lead the Department of Homeland Security	BP	politics
t3_k03gjd	Biden unveils his administration as Trump's firewall crumbles	BP	politics
t3_jzw3mj	Biden names climate statesman John Kerry as climate envoy — President-elect Joe Biden has picked climate-change older statesman John Kerry for a newly created role of climate envoy for national security	T	politics
t3_k00s3i	Vt. AFL-CIO OKs strike if Trump refuses peaceful transfer of power	T	politics
t3_k0axg0	Rush Limbaugh: Trump’s Legal Team ‘Promised Blockbuster Stuff and Then Nothing Happened’	TS	politics
t3_k05ja4	Since Election Day, a Lot of Tweeting and Not Much Else for Trump	TS	politics
t3_jzv4kr	GM withdraws support for Trump lawsuit seeking to roll back auto emissions rules	TP	politics
t3_k00bnt	Trump’s legacy may be an increasingly authoritarian Republican Party	TS	politics
t3_k0anru	Trump pops into White House briefing room for one-minute impromptu speech	TP	politics
t3_k0effc	America is back' , says Biden as he unveils team	T	politics
t3_jzzo0f	Trump is worried Giuliani and legal team are ‘fools making him look bad’	TS	politics
t3_k0bzv9	Trump Stress-Tested the Election System, and the Cracks Showed	TS	politics
t3_k08031	Trump: I’ll Keep Charging Fraud Until Randy Quaid Is Satisfied	EF	politics
t3_k0g55x	Treasury Secretary Mnuchin is moving $455 billion of unspent stimulus money into a fund the incoming Biden administration can't deploy without Congress	TP	politics
t3_k0cv6t	Biden: 'It’s a team that reflects the fact that America is back'	T	politics
t3_k02obo	Opinion | Guess Whose Votes Trump Doesn’t Want Counted	EF	politics
t3_k08b0h	Pennsylvania certifies Biden as winner of presidential vote	ER	politics
t3_k0qkgl	Biden says the White House is cooperating fully with his transition, but that Trump still won't speak to him	T	politics
t3_k0wvag	Mueller prosecutor Andrew Weissmann says Trump should be investigated and charged with potential federal crimes after leaving office	TS	politics
t3_k0ujll	Trump adviser who was with Giuliani at press conference tests positive for coronavirus	C	politics
t3_k0scsk	To Prevent 'Another Right-Wing Authoritarian' Even Worse Than Trump, Sanders Says Democrats Must Pursue Bold Working Class Agenda	TS	politics
t3_k0wcwi	Obama says Americans voted for Trump because Republicans cast white men as ‘victims’	ER	politics
t3_k114eb	Megathread: President Donald Trump Pardons General Michael Flynn	TP	politics
t3_k0oad4	Roger Stone-linked group urges voters to write in Trump in Georgia runoffs as revenge against GOP | A fringe group of Republicans is trying to sink the GOP's Senate hopes as retaliation after Trump's loss in Georgia	TP	politics
t3_k0ve3q	Prosecuting Trump is the only way to heal the nation	TS	politics
t3_k0ps90	Trump's staffers are reportedly now avoiding him to stay out of legal jeopardy	TS	politics
t3_k0pdv5	Georgia secretary of state: My family voted for Trump. He threw us under the bus anyway.	ER	politics
t3_k0x6x6	Donald Trump is losing thousands of Twitter followers after election defeat	TS	politics
t3_k0qym3	Trump Seemed to Go Along With Biden's Transition Only After Aides Told Him He Didn't Have to Admit He Lost	T	politics
t3_k0v9ok	Fauci says he would 'absolutely' serve on a Biden coronavirus task force	BP	politics
t3_k0w7hg	Biden says Trump 'will go down in history as being one of the most irresponsible presidents'	TS	politics
t3_k0sg86	Schiff on possible Flynn pardon: Trump is 'acting like an organized crime figure'	TS	politics
t3_k0pueo	Flat-Out Sabotage' Already Underway as Mnuchin Tries to Put $455 Billion in Covid Funds Out of Biden Team's Reach	C	politics
t3_k0ysz6	Scarborough says he'll never return to Republican party after GOP supported Trump	TS	politics
t3_k0tujg	A New Jersey congressman is seeking to disbar Trump's personal attorney Rudy Giuliani after he touted election-related conspiracy theories	TS	politics
t3_k0mhkc	Biden Says It Would Be 'Difficult' To Lose Sanders Or Warren From Senate For Admin.	BP	politics
t3_k0ucpe	In refusing to acknowledge Biden win, McConnell again puts politics ahead of country	ER	politics
t3_k0zcp6	In an apparent dig at the Trump administration, Obama says Biden's foreign policy team will 'know where countries are'	TS	politics
t3_k0m346	Any Republican unwilling to defy Trump is not worthy of the label ‘patriot’	TS	politics
t3_k0ssez	China’s president Xi Jinping finally congratulates Joe Biden on election win	T	politics
t3_k0tp5h	McConnell Called Trump on Air Force One After Ginsburg Died, ‘Told’ the President ‘You’ve Gotta Nominate Amy Coney Barrett’: Report	TP	politics
t3_k0zt1g	‘We’re at war with the virus, not with one another’: Biden delivers Thanksgiving address as nation reels from coronavirus	C	politics
t3_k0rq4b	Secretary of State Brad Raffensperger releases scathing op-ed criticizing President Trump	TS	politics
t3_k0w03e	Biden’s IRS could finally give Trump’s tax returns to Democrats	BP	politics
t3_k0vri0	Trump's about to turn the GOP into one long, humiliating episode of 'The Apprentice'	TS	politics
t3_k0ss25	Twitter Users Mock Melania Trump's ‘Who Gives A F**k About Christmas’ Tree	TS	politics
t3_k0urqy	Adam Schiff Says If Trump Pardons Flynn He'd Be 'Acting Like An Organized Crime Figure'	TS	politics
t3_k0t1hf	Gaetz Urges Trump To Go Wild With Pardons, Including A Self-Pardon, To Own The Libs	TP	politics
t3_k0tmzh	El Paso moves to collect outstanding debt from 2019 Trump campaign rally	TP	politics
t3_k0kkvp	Trump Hasn’t Taken Questions From the Press in Three Weeks. He Just Held a Press Conference That Lasted 90 Seconds	TP	politics
t3_k0ki19	Minnesota certifies Biden victory	ER	politics
t3_k0rv3j	Trump's economic team accused of 'sabotaging' Biden before exiting	T	politics
t3_k0jm6y	McConnell Told Trump to Nominate Amy Coney Barrett on Night of Ginsburg's Death, Ex-Chief of Staff Says	TP	politics
t3_k0lq56	Fox News Ratings Plummet After Election. Is President Trump’s Criticism the Cause?	O	politics
t3_k0q91z	How Trump’s conspiracy theories have inspired some supporters to boycott the Georgia runoffs	TS	politics
t3_k0wd4c	Trump cancels plans to attend Pennsylvania GOP event on election	TP	politics
t3_k0u20u	Trump to reportedly join Rudy Giuliani at Pennsylvania election event after aides 'tried talking him out of' going	TP	politics
t3_k0w4pc	Rahm Emanuel doesn’t deserve a job in Biden’s administration	T	politics
t3_k0v7l7	Biden to receive first daily presidential briefing on Monday	T	politics
t3_k0yc64	New Poll Shows 68% of Americans Want Senators to Block Any Corporate Biden Nominees | Progressives are calling on the president-elect to reject a "Corporate Cabinet" and instead pick "people dedicated to working in service of the general welfare."	T	politics
t3_k0zcsn	Biff is president': Michael J. Fox says Trump has played on 'every worst instinct in mankind'	TS	politics
t3_k0wmlm	Trump bails on surveillance treaty used to monitor Russia, guts program of resources	TP	politics
t3_k0j6dp	Biden becomes first presidential candidate to win more than 80 million votes	ER	politics
t3_k0tgk3	Georgia secretary of state says Trump threw him under bus despite his support	TP	politics
t3_k12qwf	Trump suddenly irrelevant, Biden steals Thanksgiving spotlight with call for unity	TS	politics
t3_k11x1z	Trump Complains On Speakerphone To PA GOP That No One Will 'Overturn' Election For Him	EF	politics
t3_k0wtut	Trump’s transgender ban has harmed US military, experts find	TP	politics
t3_k10zvu	Mnuchin clawback may “sabotage” Biden by blocking $455B in COVID-19 funds — it may also be “illegal”. A watchdog says Mnuchin’s move violated the Cares Act. Democrats call it downright "corrupt"	C	politics
t3_k0r4z7	Trump to join Rudy Giuliana at a hotel in Pennsylvania for a Republican hearing into baseless voter fraud claims	EF	politics
t3_k0uq8x	AOC and Ilhan Omar sign petition calling on Biden not to give Bruce Reed administration role	T	politics
t3_k0rwl3	Biden Promises Bill Providing Pathway to Citizenship for 11 Million Illegal Immigrants in First 100 Days	BP	politics
t3_k13ard	Almost everything Trump said at a Republican event in Pennsylvania about the election was a lie or a conspiracy theory	TS	politics
t3_k0qym5	Can Trump's lawyers be disciplined for making false claims?	O	politics
t3_k11o5n	DOJ Is Still Trying to Defend Trump Against Rape Accuser E. Jean Carroll’s Lawsuit During Lame-Duck Session	TS	politics
t3_k0zwpq	Trump demands election results ‘overturned’ and claims GOP poll watchers ‘treated like a dog’	ER	politics
t3_k12h7v	Joe Biden Should Investigate Trump, Dem Rep Argues: 'We Cannot Dismiss Accountability'	BS	politics
t3_k0ml97	Biden officially tops 80 million votes, beating Obama's record by 10 million	ER	politics
t3_k0zes8	Trump campaign sued for attempting to disenfranchise Black voters	EF	politics
t3_k0r986	Biden searches for attorney general to restore Justice Dept.’s independence, refocus on civil rights	T	politics
t3_k0jv46	Trump campaign announces Arizona public hearing on election, but lawmakers say none is planned	EF	politics
t3_k0kyt4	Donald Trump plans to pardon former national security adviser Michael Flynn – reports	TP	politics
t3_k0qbo2	Canceling Student Debt Is Very Good. Biden Won’t Do It Unless We Make Him.	BS	politics
t3_k0tmc3	AOC insists Joe Biden can forgive student loans by executive order despite constitutional questions	BS	politics
t3_k0n40v	Trump's coup failed – but US democracy has been given a scare	O	politics
t3_k11y4x	Mueller prosecutor says next attorney general should investigate Trump	TS	politics
t3_k10g9z	Bernie Sanders Criticizes Trump for Touting Dow Record as Millions of Americans Won't Have Enough Food on Thanksgiving	TS	politics
t3_k0rpg4	Archbishop Gregory stood up to Trump. Now he’s about to be the first Black cardinal in U.S.	T	politics
t3_k0vvgw	60% of US Voters Support Biden Canceling $50,000 of Student Loan Debt Per Person: Poll	ER	politics
t3_k0zjrf	Trump Knows His Lawsuits Don’t Stand a Chance, But He’s Using Them to Raise Money for His Next Move	O	politics
t3_k0qm85	Geraldo Rivera joins fellow Fox News host Laura Ingraham in urging viewers to accept Trump's defeat, saying he can't 'continue denying the results of the election'	ER	politics
t3_k0w5xq	Republicans Are Really Trying to Argue that Biden’s Cabinet Picks Are Corrupt	BS	politics
t3_k115zd	Trump calls into Pennsylvania hearing, rambles about voter fraud on speakerphone	EF	politics
t3_k0zoxm	Truly Grotesque': On Way Out the Door, Trump Prioritizes Bringing Back Executions by Firing Squad and Electrocution	TP	politics
t3_k0uxvn	Georgia secretary of state says he's a Trump voter 'now being thrown under the bus by him'	TP	politics
t3_k10by4	Trump's Tweets Attacking the Election Echo Russian Trolls	EF	politics
t3_k0yqon	The Trump administration is aiming to bring back firing squads and electrocutions for some federal executions	TP	politics
t3_k0obaj	Wisconsin officials: Trump observers obstructing recount	EF	politics
t3_k0z706	Trump Lawyer Jenna Ellis Defends Truth Using Fake Teddy Roosevelt Quote | The campaign’s legal adviser posted a tweet using a quote falsely attributed to the 26th president defending truth.	TS	politics
t3_k12bmp	Pennsylvania AG and Lt. Gov blast Trump, "fake" GOP election hearing: "devoid of reality"	TS	politics
t3_k0x266	Biden: I am not going to shut down the economy, period	BP	politics
t3_k0k7de	Mike Pompeo Is a Global Arsonist. Can Biden Put Out His Fires? | The secretary of state is igniting diplomatic infernos left and right, leaving the next administration with untold damage on its hands.	O	politics
t3_k12s6a	House Democrats seek list of Trump appointees "burrowing in" to Biden administration	T	politics
t3_k0jrc7	Trump Is Said to Plan Pardon of Flynn	TP	politics
t3_k13uia	Ocasio-Cortez doubles down on Biden keeping Emanuel out for 'covering up a murder'	BS	politics
t3_k0xlfj	Trump cancels trip to GOP fraud “hearing” at Pennsylvania Wyndham after Giuliani exposed to COVID-19. The campaign said similar "hearings" were planned in Michigan and Arizona, but that was news to GOP officials there	C	politics
t3_k0t74f	Trump's bizarre Georgia play: He wants to show Republicans he's still the boss	TP	politics
t3_k0uq91	Ga. GOP Secretary of State Says Trump 'Threw' His Family 'Under the Bus'	TS	politics
t3_k0tigo	Obama criticizes Trump on pandemic response: 'It's not rocket science'	TS	politics
t3_k0vbim	Trump’s Team Is Sabotaging the Transition	T	politics
t3_k0n63e	Sanction Trump’s Election Lawyers—Now!	O	politics
t3_k0u1nd	Putting Trump past us is like exiting an abusive relationship: it takes time. Under Trump many had a ‘collective hypervigilance and anxiety of what he might do next’, experts say – so how do we unpack these past four years?	O	politics
t3_k0t0ml	Fact check: Trump lawyer Sidney Powell falsely stated he won election 'by a landslide'	ER	politics
t3_k0wk7g	Judge Rules Against Trump Ploy to Force Elderly Into Nursing Homes. Decision Blocks Effort to Keep States from Deducting Insurance, Union Dues from Home Healthcare Workers	TP	politics
t3_k12fkx	Trump’s Lawyers Just Performed Another Embarrassing “Election Fraud” Show	TS	politics
t3_k0vm1n	Joe Biden to deliver a Thanksgiving address seeking US unity	BP	politics
t3_k13c26	Trump’s hopes sputter to end in Michigan. ‘It’s over, and they know it.’	TP	politics
t3_k0qxw7	Trump Lawyer’s Latest Praise Of The President Goes Viral For All The Wrong Reasons : Jenna Ellis described Donald Trump as a “WARRIOR.” Critics had a field day.	TS	politics
t3_k0zh1q	Trump pushing through dozens of last minute policy changes – including use of firing squads	TP	politics
t3_k0pk8a	Trump Races to Weaken Environmental and Worker Protections, and Implement Other Last-Minute Policies, Before Jan. 20	TP	politics
t3_k0nd17	Trump Reportedly Planning To Pardon Michael Flynn, Start Of Spree	TP	politics
t3_k0q6ay	Trump Plans to Attend Republican Election Hearing With Giuliani	TP	politics
t3_k0v7qa	Another Trump campaign advisor tests positive for coronavirus as Giuliani heads to Gettysburg	C	politics
t3_k0sjsl	A warning from Europe: Trump may be leaving, but right-wing populism is not	O	politics
t3_k0qrz6	Biden laid out his first 100 days in office and said he wouldn't use DOJ as his personal 'vehicle' to investigate Trump	BP	politics
t3_k0zek5	Rouhani: Iran and US can return to time before Trump	BP	politics
t3_k1043w	Trump’s handling of coronavirus pandemic ‘shambolic’, says Obama	O	politics
t3_k11tae	DOJ appeals ruling that said it can't take the place of Trump in E. Jean Carroll defamation suit	TS	politics
t3_k0uf58	Canvassing board certifies Joe Biden's win in New Mexico	ER	politics
t3_k10uhs	Trump rants about overturning the election even as administration begins transition to Biden	ER	politics
t3_k0kaf1	Biden’s win brings new hope for peace deals with Denmark and Canada	BP	politics
t3_k0wf6f	GA Secretary Of State: My Family Voted Trump And Was ‘Thrown Under The Bus’	TS	politics
t3_k0uv7d	Trump’s Election Lies Failed, but the Damage Is Done | Trump’s supporters, already steeped in white grievance, are predictably receptive to the idea that “illegal voters” have succeeded in stealing their democracy.	O	politics
t3_k0uawe	Trump tweets string of falsehoods about Wisconsin absentee voters	ER	politics
t3_k0zqlf	Biden gives Thanksgiving address from Delaware	BP	politics
t3_k10ua8	White House Weighs Pardon Blitz Before Trump’s Exit	TP	politics
t3_k0swn8	Biden says he hasn't heard from Trump directly	T	politics
t3_k0rrfe	What do Trump's 'Muslim ban,' Ukraine, and Biden smear campaigns have in common? Giuliani. |	O	politics
t3_k0r0vi	The Transition Delay Is Going to Cost Lives - Biden’s transition to the presidency may finally begin, but the ramifications of Trump’s lame-duck sabotage will linger well beyond Inauguration Day	T	politics
t3_k0lxlj	Ingraham admits Trump lost — and saying otherwise is “lying”: “This constitutes living in reality”	ER	politics
t3_k0twoj	Joe Biden’s early picks for top advisors signal a return to stability, experience and sobriety	T	politics
t3_k0r3eo	Former Republican House speaker Paul Ryan tells Trump to concede and stop ‘undermining democracy’	ER	politics
t3_k0jgvv	Janet Yellen, Biden’s Treasury Pick, Could Be Key To Confronting Climate	T	politics
t3_k0zb6z	Joe Biden becomes first presidential candidate in U.S. history to surpass 80 million votes	ER	politics
t3_k0j044	Comment: The Damage Done, the Job Ahead — Expect Trump to keep lying from the sidelines, and for his followers to stand by him.	O	politics
t3_k0jukw	Trump tells confidants he plans to pardon Michael Flynn	TP	politics
t3_k0o7wk	Biden transition event disorienting for its competence, normalcy	T	politics
t3_k0ll9c	“This Keeps Me Up at Night” Radicalization experts fear what Trump’s fringes will do now—and they aren’t certain how to stop it.	O	politics
t3_k0zp9f	President-elect Biden Delivers Thanksgiving Address	BP	politics
t3_k101h5	Biden urges Americans to recommit to fighting pandemic in Thanksgiving address	C	politics
t3_k0te8w	President-Elect Biden Hits 80 Million Votes In Year Of Record Turnout	ER	politics
t3_k0xkq3	Trump’s Embarrassingly Bad Legal Case in Pennsylvania No wonder his campaign kept swapping out its lawyers.	TP	politics
t3_k0kves	America is back': Biden formally introduces national security, foreign policy team	BP	politics
t3_k0s17r	Biden Says It Would Be 'Difficult' To Lose Sanders Or Warren From Senate For Admin	BP	politics
t3_k0k8ic	Pennsylvania officials tell court to reject Donald Trump campaign appeal as new lawsuit filed in Wisconsin	ER	politics
t3_k11ip5	Column: Brace yourself for Trump’s scorched-earth attacks on health and safety	O	politics
t3_k13n1j	Shameful': Progressives are angry Biden is considering a Cabinet post for Rahm Emanuel despite his handling of the police shooting of an unarmed Black teenager	BS	politics
t3_k0k34c	Trump crams one last racist policy into his final days as president	TS	politics
t3_k1169e	Joe Biden Says the U.S. Will Lead on Climate. But First He Has to Regain World Leaders' Trust	BP	politics
t3_k124r4	How Democrats should exploit Trump’s continued effort to hold the GOP hostage	O	politics
t3_k0kxxw	Biden’s Appointment of John Kerry as Climate Envoy Sends a ‘Signal to the World,’ Advocates Say	T	politics
t3_k0yz88	Trump team’s bizarre legal fight channels the McCarthy era	TS	politics
t3_k0jll7	Mueller 'pit bull' calls for Biden attorney general to investigate Trump	BS	politics
t3_k0j6go	Trump and a Lesson in How Coups Fail	O	politics
t3_k0k3zh	Transition Gets Underway in Earnest as Biden Team Fans Out Across Capital	T	politics
t3_k0lrm0	A reliable pandemic forecasting model says cases will nearly double by Inauguration Day. As case numbers explode across the country, Biden is poised to inherit a drastically worse crisis	C	politics
t3_k0x19o	Trump Legal Team Wants Rudy Giuliani to Argue in Federal Court Again, But There Are Some Problems	TP	politics
t3_k10put	Joe Biden calls for shared sacrifice to fight the pandemic as Trump rails about baseless election accusations	C	politics
t3_k0wlug	Trump lawyer details far-fetched strategy to reverse Pennsylvania win for Biden	ER	politics
t3_k0mgqg	Donald Trump ‘plans to pardon’ former aide Michael Flynn	TP	politics
t3_k14dck	Trump takes his fraud claims to a hotel ballroom — by phone	EF	politics
t3_k0vsz3	Losing Hasn’t Changed Trump’s Stance on White Supremacy	O	politics
t3_k0r99r	Black voters concerned that Trump campaign's efforts to overturn election targeted them	ER	politics
t3_k0spjx	Trump shares bizarre videos and tweets by actor Randy Quaid about voter fraud, Fox News	EF	politics
t3_k11ggr	Trump refuses to accept Biden's win as transition proceeds	T	politics
t3_k0w5uj	Biden Announces First LGBTQ+ Appointee in His Administration	T	politics
t3_k0r8i1	Never Trumpers' Admit Trump Has Taken Over GOP, But They're Staying To Fight	O	politics
t3_k0tynj	Michigan lawmakers told Trump they have no role in election	ER	politics
t3_k0qrcf	Trump carries on a fight everyone else is abandoning	TS	politics
t3_k0qdok	Explainer: Can Trump's lawyers be disciplined for making false claims?	TS	politics
t3_k1dokd	Trump's inner circle is telling him that Giuliani and the rest of his legal team are making him look like an idiot, report says	TS	politics
t3_k16as8	Steve Schmidt: ‘We’ve entered the corrupt pardon phase of the Trump coup’	TS	politics
t3_k1fhlv	Mueller prosecutor says Trump should be investigated and face charges after leaving office	TS	politics
t3_k1cko2	Obama says lives could have been saved if Trump hadn't disbanded pandemic response unit	C	politics
t3_k15yeb	‘Absolutely No Allegations of Any Fraud’: Pa. Court Rejects Trump Campaign’s Appeal Over 69 Mail-In Ballots	EF	politics
t3_k1g099	Pranksters have claimed a Trump 2024 campaign website domain which labels Trump a 'loser'	TS	politics
t3_k1dsa2	Donor Sues Pro-Trump Group for $2.5 Million for Failing to Prove Voter Fraud	TS	politics
t3_k1lnms	Trump Is About to Hand Over Sacred Apache Land to a Mining Company	TP	politics
t3_k17277	Giuliani thinks Trump ‘may have won Virginia’ despite Biden winning state by nearly half a million votes	ER	politics
t3_k1ezlz	Trump’s conspiracies have MAGA world talking Georgia boycott	TS	politics
t3_k1as4m	El Paso lawyered up to try and collect $570,000 owed to the city by the Trump campaign from a rally 2 years ago	TS	politics
t3_k1g08g	Ex-Trump lawyer Sidney Powell files typo-filled lawsuits in Michigan, Georgia	TP	politics
t3_k1in3b	Why Biden shouldn't extend an olive branch to Republicans	O	politics
t3_k1en3v	Donald Trump Retweets Call to Pardon Himself	TP	politics
t3_k1ca3s	Trump urges Americans to ‘gather’ for Thanksgiving in direct contradiction of official Covid guidance	C	politics
t3_k17xny	Pro-Trump Group Donor Sues Over Failure to Expose Election Fraud	EF	politics
t3_k1i58k	Why Biden Has It Harder Than FDR and Lincoln — They had big congressional majorities to pass the New Deal and fund the Union Army. Biden is the rare crisis president without the majorities he needs.	O	politics
t3_k1ghc7	Donor sues pro-Trump group over failure to prove voter fraud: 'Empty promises'	TS	politics
t3_k1gtvp	Indian country showed up to beat Trump. How can you show up for Indian country?	O	politics
t3_k1oj3g	Trump supporters reportedly calling for boycott of key Georgia Senate races	ER	politics
t3_k1hz0i	Shame the Random, Unknown Government Officials Aiding Trump’s Coup Attempt	TS	politics
t3_k1eqs1	Want to Be Like FDR, Joe Biden? Make Your Thanksgiving Proclamations Rallying Cries - The 32nd president used every tool—even Thanksgiving Proclamations—to promote a moral vision for social and economic justice. Biden should do the same.	BS	politics
t3_k18fep	Wounded' Trump caves on Biden transition as allies abandon him	T	politics
t3_k178xy	Over 30 Trump Campaign Lawsuits Have Failed. Some Rulings Are Scathing. As President Trump continues to litigate the 2020 election, some judges have lost all patience. Here are some excerpts of their rulings.	ER	politics
t3_k1at5v	Representatives for 'Tiger King's' Joe Exotic are said to be chasing Trump down for a pardon and spending thousands of dollars to get it	TP	politics
t3_k1k1dk	Ex-GOP Pennsylvania governor condemns Trump's Gettysburg meeting as attempt "to undermine the republic"	TS	politics
t3_k1p866	Trump says he will leave the White House if Electoral College votes for Biden	ER	politics
t3_k1fr77	Trump’s Last Act: Risking National Security to Honor the Confederacy. He promises to veto the Defense Appropriations Authorization Act if it forces to Pentagon to change the names of bases and ships.	TP	politics
t3_k1e6ky	Obama says Republicans won votes for Trump by wrongly framing white men as victims	ER	politics
t3_k1f7lj	Joe and Jill Biden in Thanksgiving op-ed: 'We can be apart without being alone'	BP	politics
t3_k1cwkm	Donald Trump Is the Ultimate Super-Spreader | Trump didn’t merely bungle this country’s pandemic response; he stoked the flames of this third and largest surge.	O	politics
t3_k1h7nv	Get ready for Donald Trump’s shadow government — via Twitter and Fox News: Other Republicans, in fear of the wrath of Trump’s supporters, will obstruct Joe Biden at every turn.	O	politics
t3_k1gz8z	Trump’s Thanksgiving Message Urges People To ‘Gather,’ Despite Raging Pandemic	C	politics
t3_k169vg	Donald Trump Shares Deep State Conspiracy Article That Says 'We Are at War'	TP	politics
t3_k1jggr	Leading House Dems Demand 'Full Accounting' on Trump Order Allowing Purge of Federal Workforce	BP	politics
t3_k1o6m0	Comedians Buy Trump 2024 Website Domain to Call President a 'Loser'	TS	politics
t3_k1fxbr	Trump shares tweet saying he should pardon himself, rest of his admin	TP	politics
t3_k1hyjh	Biden takes his cue from Muhammad Ali as he copes with a dope — As Ali did with Foreman, Biden has let his rival punch himself out.	BS	politics
t3_k1mhcs	Trump retweets post from GOP ally Matt Gaetz suggesting the president pardon himself and whole administration	TP	politics
t3_k1mlgj	Midnight Ruling Exposes Rifts at a Supreme Court Transformed by Trump	TP	politics
t3_k1exsn	Obama says Republicans portrayed white men as ‘victims’ to win votes for Trump	ER	politics
t3_k1j285	Biden Urged to 'Honor Indigenous Sovereignty and Immediately Halt' Fossil Fuel Pipelines	BS	politics
t3_k1i6ol	Investor Sues to Get His $2.5 Million Back After Supporting True the Vote’s Flailing Pro-Trump Election Suits.	TS	politics
t3_k17k4y	Trump wages war on our country and the rule of law one last time	TS	politics
t3_k1e7r8	Trump retweets congressman urging him to pardon himself	TP	politics
t3_k1m30w	Some Trump voters still believe he can retain the presidency	ER	politics
t3_k1i78k	PA Lt. Governor to Trump lawyer Giuliani: Where's the voter fraud? | Rudy Giuliani and Donald Trump are still attacking Pennsylvania's election results. The commonwealth's Lt. Governor John Fetterman says the evidence for that fraud simply does not exist.	EF	politics
t3_k1fqxm	Biden predicted a GOP 'epiphany' after the election. Trump's standing in the way.	BS	politics
t3_k19487	Over phone, Trump tells Pennsylvania hearing U.S. election must be ‘turned around’	ER	politics
t3_k17yc5	Biden Urged to 'Honor Indigenous Sovereignty and Immediately Halt' Fossil Fuel Pipelines	BS	politics
t3_k1guvu	Bidens Highlight 'Sacrifice' of Staying Home for Thanksgiving While Trump Urges Americans to Gather	C	politics
t3_k1pktd	Donald Trump says he will leave the White House if Joe Biden is confirmed by electoral college	ER	politics
t3_k1gsph	Biden to face test over access to sensitive information as he inherits Trump's secret server	T	politics
t3_k1gw51	Trump’s baseless election fraud claims in Georgia turn Senate runoffs into a ‘high-wire act’ for Republicans	EF	politics
t3_k1p3nm	Trump Supporters Want to Boycott the Georgia Runoffs. Is Their Threat Genuine?	EF	politics
t3_k1m6vv	Teddy Roosevelt relative joins mockery of Trump ‘elite strike force’ lawyer for misquoting his ancestor: The former president’s great-grandson mocked Jenna Ellis’s ‘ifea’ defence for misquote	TS	politics
t3_k1cb5e	Trump Retweets Rep. Matt Gaetz Urging Him to Pardon Himself	TP	politics
t3_k1720h	Biden promises some student loan forgiveness. Student borrowers hope he delivers.	BP	politics
t3_k1o9e2	Ex-Trump Lawyer Sidney Powell Mocked For Typo-Laden Lawsuits	TS	politics
t3_k1l51b	They’re Baaack: Trump and Allies Still Refuse Election Loss	ER	politics
t3_k1ndvj	Error-riddled lawsuit filed in Georgia by Ex-Trump lawyer	TS	politics
t3_k1ofbw	Justice Department appeals order it cannot rep. Trump in E. Jean Carroll case	TS	politics
t3_k1mojr	Trump administration removes experts from Defense Policy Board	TP	politics
t3_k1ie4m	‘A polite coup d’etat’: Trump and allies continue baseless claims on U.S. election	ER	politics
t3_k1g86b	They're baaack: Trump and allies still refuse election loss	ER	politics
t3_k1powx	Trump says it will be 'a very hard thing' to concede to Biden	ER	politics
t3_k1p8x2	US election result: Trump comes step closer to conceding as he says he will respect Electoral College vote	ER	politics
t3_k1gz8v	Secluded and deluded: Trump’s post-election actions show a mad-monarch mindset	O	politics
t3_k1oemk	‘I know this isn’t the way we hoped we’d spend our holiday’: Bidens send a Thanksgiving message to the nation	C	politics
t3_k1a37f	Trump fixates on bogus election claims, leaves Americans struggling without Covid relief	C	politics
t3_k1h61e	Trump Races to Weaken Environmental and Worker Protections, and Implement Other Last-Minute Policies, Before Jan. 20	TP	politics
t3_k1ep1i	Trump Tweets Bogus Poll Backing His Refusal to Concede	ER	politics
t3_k1p2pk	‘Loser’: How a Lifelong Fear Bookended Trump’s Presidency. The president’s inability to concede the election is the latest reality-denying moment in a career preoccupied with an epithet.	ER	politics
t3_k1jqka	New Rule Would Allow U.S. to Use More Methods for Executions — The rule, which would permit methods including firing squads and electrocution, comes as the administration rushes to execute five more prisoners before President Trump’s term ends.	TP	politics
t3_k1j9gh	Citing conspiracy theories, Michigan GOP electors ask court to name Trump winner	ER	politics
t3_k1e1r5	A sweet Thanksgiving after all: America has rebuffed Trump's assault on democracy	O	politics
t3_k1ndor	Donald Trump should pardon Joe Exotic and himself to combat ‘radical left bloodlust’, says congressman	TP	politics
t3_k1l7ht	DOJ to Appeal Judge's Injunction Against 'Cruel, Unprecedented Policy' of Deporting Migrant Children | The Trump administration—which has denied the severity of the coronavirus pandemic and seized infants from their parents—claims it is acting in the interest of public health and children.	TS	politics
t3_k1eyky	They’re baaack: Trump and allies still refuse election loss	ER	politics
t3_k1q2fd	After Trump retweets call to pardon himself, Fox News asks "can he?"	TS	politics
t3_k16xcm	Biden victory in hand, Black church get-out-the-vote workers assess the future	ER	politics
t3_k1qmwz	Noam Chomsky: Trump Has Revealed the Extreme Fragility of American Democracy	O	politics
t3_k1po3b	Trump Is Leaving the White House. Meanwhile, He’s Escalating His Execution Spree.	TP	politics
t3_k1ik5o	Trump’s Last Act: Risking National Security to Honor the Confederacy — He promises to veto the Defense Appropriations Authorization Act if it forces Pentagon to change the names of bases and ships.	TP	politics
t3_k1jara	Trump Rushes to Weaken Environmental and Worker Protections Before January 20	TP	politics
t3_k1igbf	Trump Is Trying to Bring Back Firing Squads	TP	politics
t3_k19nd4	Biden and Harris to skip big Thanksgiving celebrations	C	politics
t3_k17428	What happens if Trump gets pardon-happy in his final days in office	TS	politics
t3_k16m05	Journalist Carl Bernstein says Sen. Rob Portman despises Trump. Spokeswoman says that's not true.	TS	politics
t3_k1ezsv	Joe Biden Defends His Cabinet Choices: 'This Is Not A Third Obama Term'	BS	politics
t3_k1pwhs	Trump says he will leave if electoral college votes for Biden	ER	politics
t3_k1h3fq	No Pardon Can Save Trump’s Terrible Thanksgiving	O	politics
t3_k15p9e	Donald Trump still believes US election was ‘rigged’	EF	politics
t3_k1e6zb	Only a quarter of Republicans believe Donald Trump should concede	ER	politics
t3_k1dp4g	Barack Obama has taken a swipe at Hispanic voters who chose Donald Trump, accusing them of ignoring the US president's "racist" comments.	ER	politics
t3_k1n0su	In Georgia, Republicans juggle Biden win and Trump loyalties	TP	politics
t3_k1pmcb	Column: Trump does his worst to make Biden's job even tougher	O	politics
t3_k19tun	Federal Court Rejects Challenge To Trump's Push To Alter A Key Census Count	ER	politics
t3_k19s2w	Immigrant advocates to Biden: Be better than Obama	BS	politics
t3_k1ptd8	Trump says he'll leave White House if Biden declared winner of Electoral College	ER	politics
t3_k1qpk7	In Thanksgiving Message, Trump Says ‘We’re Like a Third-World Country’ Because He Lost Election	ER	politics
t3_k1nj9u	China is likely to be Biden’s biggest cybersecurity challenge	BP	politics
t3_k1pohl	Trump Says He Will Leave the White House if Electoral College Votes for Biden	ER	politics
t3_k1gch7	Biden tries to spread calm, as some Democrats worry about his willingness to fight	BS	politics
t3_k1p3lo	Trump Sought Options for Attacking Iran to Stop Its Growing Nuclear Program	TP	politics
t3_k1pgg0	Trump Defiant in Thanksgiving Remarks, Unwilling to Concede	ER	politics
t3_k1fqf3	Joe and Jill Biden: Our most important Thanksgiving tradition	O	politics
t3_k1ijh0	Trump Shared a Tweet Saying He Should Pardon Himself, and Joe Exotic	TP	politics
t3_k1q67z	Just In: Trump says he'll leave White House if Biden declared winner of Electoral College	ER	politics
t3_k1pss6	Donald Trump says he will leave White House if electoral college votes for Joe Biden	ER	politics
t3_k1r17h	Man sues for refund of $2.5m he donated to Trump election challenge group	TS	politics
t3_k1o3jz	MIT's Ernie Moniz Is On Biden's Short List For Energy Secretary — Thrilling Energy Wonks But Disappointing Progressives	T	politics
t3_k1jbye	Where does the Trump team go next with its legal complaints? Nowhere fast	O	politics
t3_k1d9vf	Strongmen review: a chilling history for one nation no longer under Trump	O	politics
t3_k1iwvy	Fact-checking Trump’s cellphone rant of election falsehoods	EF	politics
t3_k1gjjk	Biden's Next Climate Chief Will Tackle 'Existential Threat' At Home	BP	politics
t3_k1qq5l	President Trump will spend his last months in office pardoning turkeys: President Trump will spend the last two months in office giving a pass to all the felons, chancers, and ne’er-do-wells who supported and enabled him. Strap in.	TP	politics
t3_k1c1h2	Xi Jinping calls to congratulate Joe Biden on election win	BP	politics
t3_k1hzfe	Tulsi Gabbard Urges Donald Trump to Pardon Edward Snowden and Julian Assange	TP	politics
t3_k1em7w	Bolsonaro takes swipe at Biden and again dismisses Covid deaths	C	politics
t3_k1jy86	The Other America: The New Politics of the Poor in Joe Biden’s (and Mitch McConnell’s) USA	O	politics
t3_k1b6nz	In Trump and Biden, reality and fantasy collide on Thanksgiving	O	politics
t3_k16g6m	Flournoy gets progressive boost in Biden's search for Pentagon chief	BP	politics
t3_k1qxtt	I'm the President of the United States!': Trump flips out on reporter	TS	politics
t3_k1ixt6	They're baaack: Trump and allies still refuse election loss	ER	politics
t3_k1kea4	Yes, Trump can pardon himself — but it's a risky move that won't protect him from all prosecutions he could face	TP	politics
t3_k1q0aw	Angry Trump promises rally in battleground state of Georgia	TS	politics
t3_k1a2et	Biden seeks unity as Trump stokes fading embers of campaign	TS	politics
t3_k1h510	Trump set for precedent breaking lame-duck period	TS	politics
t3_k1qwrl	Trump Says He’s Not Thankful, Refuses To Say If He Will Attend Biden Inauguration	TS	politics
t3_k1o6fk	Joe Biden dreams of a healing nation. For now, a dream is about all he’s got	BS	politics
t3_k1qiwk	Trump says he'll travel to Georgia to support Republican Senate candidates in runoff election	TP	politics
t3_k1eidz	Defeat Trump. OK, Now Comes the Hard Part.	T	politics
t3_k1iro9	Julian Assange’s partner appeals to Trump to pardon him	TP	politics
t3_k1dr3y	Trump's next two months of mayhem	TP	politics
t3_k1qr9c	Overseas celebrations after Biden-Harris win	ER	politics
t3_k1j4uj	Vaccine skepticism emerges as early test for Biden	C	politics
t3_k1eelw	As Biden administration ramps up, Trump legal effort drags on	TP	politics
t3_k1qf53	Angry Trump promises rally in battleground state of Georgia	TP	politics
t3_k1ik8e	Biden, Trump celebrate Thanksgiving quietly at home as pandemic rages	C	politics
t3_k1dp1j	The Biden Presidency Already Has Its First Conspiracy Theory: The Great Reset : Usually, you become president before the crazy starts. But Biden still has weeks to go till he assumes office.	BS	politics
t3_k1hoai	Polling Shows Why Trump Will Retain His Bully Pulpit With the GOP Base Even After He Leaves Office: GOP voters see the president -- not his allies in Congress -- as their champion, and most would back him in 2024.	ER	politics
t3_k1gqzc	Trump can be the greatest loser	O	politics
t3_k1edco	Joe Biden considers Roger Ferguson to lead National Economic Council, Gary Gensler for Deputy Treasury Secretary	T	politics