Name	Title	Coding	Subreddit
t3_jzta4e	Trump Administration To Start Transition Process For Biden	T	
t3_jzfqzc	Do Trump-Supporters Live in an Alternate Universe? Actually a huge number of Americans have a false impression of reality because they are being told lies by their media. The people who constantly hear these lies do live in an "alternate reality."	TS	
t3_jzqpbm	Rush Limbaugh criticizes Trump legal team for promising 'bombshells' and failing to deliver	TS	
t3_jzms1q	Pro-Trump Attorney Lin Wood Urges Republicans Not To Vote In Georgia Senate Runoff -- Unless GOP candidates help overturn the presidential election results in the state.	EF	
t3_jzti5c	GSA Sends Letter to Biden Making Resources Available for Transition	T	
t3_jz9dqx	Lou Dobbs Warns the GOP: Republican Party ‘Will Be Gone and Done’ If They Don’t Stand With President Trump	TS	
t3_jzlwxs	Bombshell: Biden takes min 98% of a 23,487 vote batch at 12:18AM in GA	ER	
t3_jzjbne	Sidney Powell Confirms Non-Affiliation With Trump Legal Team, Vows to Continue Fraud Fight	EF	
t3_jzk9j0	Sidney Powell Responds to Trump Campaign's Statement Saying She's Not Part of Legal Team -- Powell said her fight will go on anyway and closed her statement with the hashtag, "#KrakenOnSteroids"	TS	
t3_jzjzln	A Neighbor You Like Probably Voted For Trump	ER	
t3_jzitza	Why The Left Can Be So Ridiculously Self-Righteous Without Realizing It -- What we saw in the lead up to the elections, and what we’ll witness for years to come, is utter contempt for Trump voters and conservatives in general.	TS	
t3_jzjptq	Two-thirds of GOP voters support Trump running for president in 2024: survey	O	
t3_jznypc	Trump campaign takes Pennsylvania election fight to federal appeals court	EF	
t3_jzjlmh	Democrat House Losses Stemmed From Trump Increasing Voter Turnout: Rep. Richmond	ER	
t3_jzbqm7	Trump campaign demands recount, signature matching in Georgia	EF	
t3_jzpd7w	JUST IN: Third Circuit Court of Appeals Grants Expedited Review For Team Trump’s Appeal in Pennsylvania	EF	
t3_jzi0vw	5 More Ways Joe Biden Magically Outperformed Election Norms	ER	
t3_jzloh0	Watergate journalist Carl Bernstein outs 21 Republican senators who 'privately' expressed 'extreme contempt' for Trump.	TS	
t3_jzijpr	Trump Pulls Out Of Military Transparency Treaty With Russia, Europe	TP	
t3_jzu0rh	Rush Limbaugh On Trump’s Legal Team: ‘They Promised Blockbuster Stuff And Then Nothing Happened’	TS	
t3_jzqca2	Trump scores two wins as Michigan legislature, federal appeals court agree to election reviews	EF	
t3_jznr0d	Appeals Court Grants Expedited Review of Trump Campaign's Pennsylvania Lawsuit	EF	
t3_jzua12	GSA notifies Joe Biden that Trump administration is ready to start transition process	T	
t3_jzn4sl	Biden proposes John Poulos, CEO and President of Dominion Voting Systems, as Surgeon General and Head of Covid Analytics. Dominion will now be solely in charge of recording and keeping an exact count of what has become the most deadly virus in the history of the world.	BP	
t3_jzi8g6	Trump’s legal team’s statement on Sydney Powell was made to focus on the upcoming Supreme Court case. There are two separate legal pathways. One on equal protection and PA voting rules (most important right now). The second is Dominion software which will take longer.	TP	
t3_jzu8wb	Trump accepts transition to Biden can begin	T	
t3_jzo4tp	Journalist Carl Bernstein names 21 GOP senators who 'privately expressed their disdain' for Trump	TS	
t3_jzmj9c	Political Enemy List Trump Accountability Project Publicly Posted on Their Website	TS	
t3_jzpdpe	Trump's election lawsuit leads to 3rd Circuit grant for expedited review	EF	
t3_jzjgop	Open Letter Calls on Harvard to Create 'System of Accountability' for Inviting Trump Admin Alums to Campus	TS	
t3_jzpzzc	Janet Yellen Is Biden’s Pick for Treasury Secretary	BP	
t3_jzl6re	5 More Ways Joe Biden Magically Outperformed Election Norms	ER	
t3_jzntsc	GOP Former National Security Officials Urge Party to Demand Trump Concession	EF	
t3_jzkul5	Trump: More Votes Than Voters in Key Swing States	EF	
t3_jzq15s	Rush Limbaugh: Trump Needs to Hold Rallies in Georgia	TP	
t3_jzmy0e	Joe Biden is a very weak President, could start wars': Chinese government advisor | World News - Times of India	BS	
t3_jzhelc	Mike Flynn Jr. adds twist to Trump team’s statement on Sidney Powell: ‘Give this the 24hr rule …’	TS	
t3_jzud9p	Bernstein names 21 Republican senators who privately expressed contempt for Trump	TS	
t3_jzrhs0	Biden's Treasury Secretary: Janet Yellen	BP	
t3_jzkxnl	Professor causes uproar asking Biden voters to unfriend him	BS	
t3_jzmvum	Appeals Court Grants Expedited Review of Trump Campaign's Pennsylvania Lawsuit	EF	
t3_jzaqqe	An statement from Senator Toomey regarding the Pennyslvania Federal Court decision regarding the Trump campaign lawsuit.	EF	
t3_jzqyu6	Joel Kotkin: The Green End Game Runs Through Biden	BP	
t3_jzo3u5	Obama's third term: Biden reveals first cabinet picks	BS	
t3_jzaje9	Scranton dedicates 'Joe Biden Way' to honor president-elect	O	
t3_jzq2wb	Sidney Powell responds to Trump Campaign legal statement with agreement but an “epic” lawsuit is still coming this week	TS	
t3_jzhbcz	The Death Star Strategy: Is Trump Contemplating The Ultimate Constitutional Trick Shot?	TS	
t3_jzu0lg	Walter Mead: Biden’s Foreign-Policy Team Takes Shape	BP	
t3_jznsl5	Biden secretary of state pick Blinken criticized over Iraq War, consulting work	BS	
t3_jzexf7	Trump’s gains in North Philly show Latino voters are not a ‘gimme’ for Democrats	ER	
t3_jzu5h2	The Socio-Political Legacy 0f Trump	TS	
t3_jznbrr	U.S. Election: Trump legal team distances itself from lawyer after controversial comments - National | Globalnews.ca	TS	
t3_jzsxow	Trump Lawyer: Michigan Legislature Agrees to Hold Election Review Hearings	EF	
t3_jzrh4s	Hours After Biden Picks Blinken For Secretary Of State – His Closet Door Swings Open On Iraq And Consulting	BS	
t3_jzrc5e	Rep. Nunes Worried Biden Will Shut Down Durham Investigation	BS	
t3_jzdaid	Report: Maryland Gov. Larry Hogan, Anti-Trump Hero, Paid for Flawed Coronavirus Tests from South Korea	TS	
t3_jzcm4f	Report: Biden to Name Russia Hoaxer, CNN Analyst Tony Blinken Secretary of State	BP	
t3_jz8xh4	Trump campaign to appeal dismissal of election lawsuit in Pennsylvania	EF	
t3_jzlu2s	All Republicans should support President Trump's legal fights -- Any who believe that buddying up to the Biden team is a symbol of unity, and better for America, have already abandoned Trump, conservatism, and America.	TS	
t3_jzk5a1	A Circuit Breaker on Election Night? (...nearly 30 percent of Democrat voters think the election was stolen from Trump)	EF	
t3_jzieod	GOP Can't Let Trump-Hating Squishes Take Over the Party Now	TS	
t3_jzjii3	Mark Levin: Letting Trump's legal efforts play out far better than 'what the Democrats are doing to our institutions'	BS	
t3_jztzoa	The mullah report: is Biden bringing back the Iran Deal? | Spectator USA	BP	
t3_jzt2hb	Data: Trump's Anti-Globalism, Pro-Police Message Wins Over Hispanics	TP	
t3_jzsh0c	Trump Lawyer: Michigan Legislature Agrees to Hold Election Review Hearings	EF	
t3_jzl08r	Biden's Surge In Polls Motivated By Fear	O	
t3_jzkyjm	NY Mag Scientifically Proves Biden Supporters Are Racist	BS	
t3_jztwv2	Revolving Door: Obama Staffers Who Joined NBC, MSNBC, and CNN, Now Headed to Biden Admin	BS	
t3_jzrsl7	DuPont’s Shaped Biden’s "Views" (no experience!) on Business	BS	
t3_jzrfhk	Biden &amp; Corporate Charters: A Radical, Regressive Proposal	BS	
t3_jzqrab	Poll: Americans Want Biden to Stay Out of Trump Investigations &amp; Pass on Progressive Policies for Now	TS	
t3_jzkwq8	Study: Biden won thousands of illegal votes by noncitizens	EF	
t3_jzbe4j	Orwell's 1984 is prophetic: How the leftists are trying to change and erase President Trump and history	O	
t3_jz90wi	Obamas Collaborating on Anti-Trump Netflix Serie	O	
t3_jzhhqb	Once an election has been shown dirty, all voters have been disenfranchised- "Joe Biden won illegal votes from thousands of noncitizens, study shows"	EF	
t3_jzt98m	Appeals Court Grants Expedited Review of Trump Campaign's Pennsylvania Lawsuit	EF	
t3_jzrtvc	N.Y. Times op-ed admits: Trump was correct, reopen the schools	TP	
t3_jzicud	Here Comes the Biden Blame Game - If the double-dip recession hits next year, Biden will remind us over and over that it’s Donald Trump’s fault. He’ll be wrong.	BS	
t3_jz995u	President Trump in virtual G-20 remarks: "The Paris Accord was not designed to save the environment -- it was designed to kill the American economy."	TP	
t3_jzt6dy	Appeals court to review Trump's Pennsylvania case -- Legal team on track with plan to reach Supreme Court	EF	
t3_jz8s6s	Mail in ballots come in envelopes. They have creases. "Ga Poll Worker Describes Pristine Mail In Ballots, 98% for Biden"	EF	
t3_jzth0n	Seven Letter Poll: 79 Percent of Trump Voters Say Election 'Stolen'	EF	
t3_jzsv52	Hunter Biden Arrives At White House Dressed As Turkey In Hopes Of Being Pardoned By Trump	BS	
t3_k080zd	FBI Buried Hunter Biden Laptop: It’s unlikely there was ever any investigation at all.	BS	
t3_k0ao2g	Biden’s win in Nevada certified by Nevada Supreme Court	ER	
t3_k02wgo	Maxine Waters Pushes for Investigation of 'Criminal' Trump To 'Send a Message Across the World'	TS	
t3_jzx2jg	James Mattis: Joe Biden Must 'Eliminate "America First"' from U.S. Foreign Policy	O	
t3_k0ddev	Nolte: Only 3% of Trump Voters Believe Joe Biden Is Legitimate Winner	EF	
t3_k05eu0	Trump lawsuit confuses Michigan and Minnesota locations in affidavit claiming voter fraud	EF	
t3_k08cy8	Trump campaign continues to fight as more evidence of voter fraud emerges	EF	
t3_k056dg	John Brennan's breathless &amp;amp; dramatic thread bidding farewell to the president is met with calls for Trump to 'declassify everything'	O	
t3_jzzay5	Trump Won't Budge From Veto Threat Over Renaming Bases Honoring Confederates	TS	
t3_jzuvjc	Trump Administration Begins Transition Process	T	
t3_k084zn	FNC's Laura Ingraham: 'I Would Be Lying to You' if I Said There Was an 'Excellent' Chance SCOTUS Delivers Victory to Trump	EF	
t3_k0b0kz	Trump vows he’ll ‘never concede’ despite administration starting transition move	T	
t3_k0cbf4	Rashida Tlaib accused of anti-Semitism for reaction to Biden's Jewish Sec of State nominee	O	
t3_k0eyot	Joseph Nye: "Trump deserves credit for pushing back on China's abusive trade practices, but it would have been better if we worked with our allies to isolate China. Also, his trade deal has been costly for Americans without changing the trade imbalance or addressing technological issues."	TP	
t3_k0dlm3	Pennsylvania, Nevada certify election results for Biden despite Trump legal challenges	ER	
t3_k082id	Biden's Pick For National Security Adviser Is A Steele Dossier Truther	BP	
t3_k0eqm4	After joining Burisma, Hunter Biden requested meetings with Antony Blinken, Biden's Pick for Secretary of State	BP	
t3_k0ex0g	Dominion Executive: Trump is not going to win. I made f***ing sure of that.	TS	
t3_k0cb1h	Hawley 2024? Missouri Republican could be ‘Trump 2.0,’ say conservative supporters	O	
t3_jzvs4f	Trump Tells GSA, and His Team, to Begin the Transition Process; Vows to ‘Keep Up the Good Fight’	T	
t3_k085p9	Rubio derides Biden's foreign policy team: 'Polite and orderly caretakers of America's decline'	BS	
t3_k0f9nk	Where are the Republican Politicians? Have they Deserted Trump?	TS	
t3_k0dwph	Mattis says he hopes Joe Biden takes 'America First' out of national security strategy	BP	
t3_k0c7j8	Chris Evans, Zach Braff Want A List Of ‘Trump Enablers’	TS	
t3_k0elxb	The Fourth Estate: Andrea Mitchell reports that a Biden administration isn't going to be political	BS	
t3_k0fcyi	Poll: One In Six Biden Voters Would Have Changed Their Vote If They Had Known About Scandals Suppressed By Media	BS	
t3_k0flpb	Hunter Biden Arrives At White House Dressed As Turkey In Hopes Of Being Pardoned By Trump	BS	
t3_k0ei4s	Dan Bongino hints at potential run for president in 2024 if Larry Hogan runs and no Trump does	O	
t3_jzw2s8	Trump Tells GSA, and His Team, to Begin the Transition Process; Vows to ‘Keep Up the Good Fight’	T	
t3_k0flhj	Biden’s Gun-Registration Scheme Would Cost Firearm Owners Billions — If It Passed Congress and Americans Complied	BP	
t3_k0flki	Mueller Probe's Andrew Weissmann Wants Biden DOJ to Prosecute Trump	TS	
t3_k0gw1d	Holman Jenkins: Media Hysteria Is the Trump Show	TS	
t3_k0gu0e	Biden’s Cabinet: The Return of the Blob	BP	
t3_k0fhm7	The Biden Popular Front Is Doomed to Unravel	BS	
t3_k0cwtc	Google Plots to Use the Biden Administration to Avoid Accountability	BS	
t3_k0e8yx	Poll Shows Media Censorship Cheated Voters of Vital Info, Robbed Trump of Second Term	EF	
t3_k0ccte	Trump: Voters are '100% correct' that 2020 'election was stolen' -- Jenna Ellis: 'Media chatter of Joe Biden picking his cabinet is like fantasy football'	BS	
t3_k089yi	Malevolent travelers' coming if Trump's travel ban killed -- Biden has promised to eliminate executive order on 'Day 1'	TS	
t3_k0gusb	EXPLOSIVE Study: Media Suppression of 8 Key Stories 'Stole This Election' for Joe Biden	BS	
t3_k0azmb	Computer Repair Shop Involved in Hunter Biden Laptop Scandal Shuttered	BS	
t3_k07tg5	Sidney Powell responds after Trump campaign says she is not part of legal team: '#KrakenOnSteroids'	TS	
t3_k06ko7	Biden’s Student Loan Bailouts: Bad Economics, A Regressive Tax, And A Moral Hazard	BP	
t3_k07qob	Patrick Buchanan: "What Trump Will Leave in Biden's Inbox"	T	
t3_k06k0b	Two of Joe Biden's national security picks have ties to past scandals	BS	
t3_k05c36	War and more war coming with Biden’s Sec. of State Blinken	BP	
t3_k0bxsq	From revolution to restoration: Biden picks Blinken, Yellen, Kerry for plum posts	BP	
t3_k06hmi	Graham warns Biden, Pelosi and Schumer would form 'trifecta from hell' if Democrats take Senate	O	
t3_jzvyov	Perdue, Loeffler Join Trump Call for New Georgia Recount	EF	
t3_k0gldq	President Trump won?	ER	
t3_k0e90v	Secretary of state pick Antony Blinken met twice with Hunter Biden	BS	
t3_k087mh	In picking John Kerry as his cabinet-level “climate czar,” Joe Biden is signaling strong support for Rep. Alexandria Ocasio-Cortez’s costly Green New Deal. Rumors are circulating that AOC is being considered for EPA administrator or elsewhere in the administration.	BP	
t3_k0bp1y	Election Aftermath: Either Or -- It is down to an “either or” situation: either President Trump prevails in his lawsuits and multiple constitutional paths to reelection, or Joe Biden and the Democrats succeed in stealing the election.	EF	
t3_k04poa	Fearing break-up, Facebook plans to woo Joe Biden with new vaccine and climate change PR	O	
t3_k01ja2	Alan Dershowitz Says Trump Still Has ‘Two or Three Constitutional Paths’ To A 2020 Victory – But He Hasn’t Seen The Evidence To Overturn	EF	
t3_k0dv2v	WJ Live': The Viral Memo Changing the Trump Legal Strategy	TP	
t3_k0ah7t	Ted Cruz Hits AOC for Criticizing Senate Recess. "AOC seems not to know there are Democrats in the Senate. Or that Joe Biden (also a Dem) is publicly calling on Senate Dems to continue filibustering COVID relief because he thinks it will help them win Georgia.”	ER	
t3_k06f5y	2020 has been miserable in so many ways. Well here's an uplifting story guaranteed to make you smile and feel better. It's a heartwarming story of two deceased voters who made their voices heard for biden.	EF	
t3_jzyv4s	Jenna Ellis insulted Trump and his supporters in 2016. The RINOs are on the inside.	O	
t3_jzyhtm	Biden climate envoy John Kerry is a lifelong joke	BS	
t3_k0ajsq	Joe Biden Central-Planning Ambitions Dangerous	BP	
t3_k03aro	Study: Biden received thousands of non-citizen illegal votes in battleground states	EF	
t3_jzvcjq	Biden's national security adviser pick played key role in Clinton email scandal	BS	
t3_jzxk30	Study: Noncitizen votes gave Biden wins in Arizona, Georgia -- 'Decimates' claim there's 'no evidence of large-scale fraud'	EF	
t3_k04ftf	Study: Biden won thousands of illegal votes by noncitizens	EF	
t3_jzv44u	Trump Supporter Charged with Simple Assault for Breathing on Protesters	TS	
t3_k04g30	NY Mag Scientifically Proves Biden Supporters Are Racist	BS	
t3_jzyvw1	Tucker Carlson: Yes, the election was rigged for Joe Biden. Here's how	EF	
t3_k0wrot	Trump 1st President Since Carter Not to Send Troops Into New Conflict	TP	
t3_k0k9nr	Donald Trump on Mattis' Remarks that "America First" Policy Should Be Abandoned: "That says it all about Mattis. Obama fired him. I should have fired him sooner."	TP	
t3_k10tra	BREAKING: Trump pardons former national security adviser Mike Flynn	TP	
t3_k0klvg	President Trump 'is planning to pardon his national security adviser Michael Flynn'	TP	
t3_k0p5yb	Only 3% of President Donald Trump voters believe that Joe Biden legitimately won the 2020 election	EF	
t3_k1057w	Audible Gasps and Laughter From Crowd and Panel at PA Hearing When Witness Says Vote “Spikes” Went 600,000 For Biden and 3,200 For Trump (VIDEO)	EF	
t3_k0tinx	Newsmax Calls Biden Winner in Mich., Nevada, Pa. Based on Certifications	ER	
t3_k0xloo	Obama takes jab at Hispanic voters for supporting Trump.	ER	
t3_k0zuxz	Huge court win lets Trump present ballot evidence, could overturn Nevada result	EF	
t3_k0j2vo	Predicting a second Trump term, Sidney Powell says 'massive' Georgia lawsuit coming by Thanksgiving eve	EF	
t3_k0jq0y	Pennsylvania, Arizona, Michigan Legislatures to Hold Public Hearings on Election: Trump Campaign	EF	
t3_k0l7fa	Watch–Joe Biden: Amnesty for Over 11 Million Illegal Aliens Going to Senate in My First 100 Days	BP	
t3_k0jilv	White House press caught laughing at McEnany and Trump -- 'They got COVID. They lost the election'	O	
t3_k0tdrc	CNN Credits Biden for Dow Hitting 30,000 for the First Time: AIR.TV	O	
t3_k10suc	Days After Pennsylvania Tries To Certify Election – Judge Intervenes For Trump, Blocks Any Further Certification Pending Hearing	EF	
t3_k0ji3v	PA Rep. Guy Reschenthaler: Pa. Certifying Tainted Results 'Reckless' -- "Secretary Boockvar said Pennsylvania was going to go to Joe Biden before voting even started."	EF	
t3_k10qr9	BREAKING: Trump pardons former national security adviser Mike Flynn	TP	
t3_k0xmvl	Huge court win lets Trump present ballot evidence, could overturn Nevada result	EF	
t3_k0yu2x	Keith Olbermann Unhinged — ‘We need to turn Trump Hotels into prisons for his supporters’…	O	
t3_k1188p	Without Evidence, Former President Obama Accuses Hispanic Trump Voters Of Bigotry	O	
t3_k0yjr6	Major LGBT Group Urges Biden to Strip Accreditation of Christian Schools, Colleges	BP	
t3_k0t3ex	Exit Polls Suggest Little Enthusiasm for Biden among Union Members	O	
t3_k0szmt	Sorry Media, Trump Is Still President And This Is Still His Stock Market	O	
t3_k0jbio	Potential Joe Biden White House Staffer Justified Palestinian Suicide Bombers	BS	
t3_k0w69z	We did it': Fox News owner's wife celebrated Biden's projected presidential win in a tweet	O	
t3_k131h4	Trump Pardons Michael Flynn -- ‘have a truly fantastic Thanksgiving!’ -- Flynn Tweets Jeremiah 1:19: ‘they shall fight against thee; but they shall not prevail against thee’	TP	
t3_k0laop	That was weird as s***': White House reporters left bemused by Trump's press appearance	TS	
t3_k13h4j	Biden says 'we're all in this together' as Dem politicians keep getting caught breaking coronavirus rules	PO	
t3_k12pis	Obama invites avalanche of criticism with 'condescending' remarks on Hispanic Trump supporters	O	
t3_k0l9eh	Report: President Trump Plans to Pardon Michael Flynn	TP	
t3_k114gy	Pres. Trump pardons Mike Flynn	TP	
t3_k11l8q	Trump announces pardon of former National Security Advisor Michael Flynn	TP	
t3_k0wh1v	Chris Evans, Zach Braff Want A List Of ‘Trump Enablers’	O	
t3_k0zib6	Huge court win lets Trump present ballot evidence, could overturn Nevada result	EF	
t3_k11pj7	President Trump pardons ex-natl security adviser Michael Flynn; ends three-year legal odyssey	TP	
t3_k0ko0q	Trump told confidants he intends to pardon Michael Flynn: report	TP	
t3_k11zdw	Trump Addresses Irregularities in Pennsylvania: 'We Won This Election by a Lot'	EF	
t3_k0usew	Computer repairman at center of 'Biden laptop' scandal closes shop, disappears amid purported death threats	BS	
t3_k0rt9n	CNBC/Change Poll: Only 3 Percent Of Trump Voters Consider Election Legitimate	EF	
t3_k0lrpi	Joe Biden is reviving all of his past failures — and it won’t stop	BS	
t3_k139fk	German Minister of Defence: President Trump was correct to pressure Germany to spend more on defense	TP	
t3_k12cad	BREAKING: Trump Pardons Former National Security Adviser Michael Flynn	TP	
t3_k0r5t4	President Trump plans to pardon Michael Flynn: Reports	TP	
t3_k0jgse	Tucker Carlson Has Epic Rant About the Real Theft of the Election: "The system was rigged against one candidate" (Trump agrees)	EF	
t3_k0ja69	Biden Picks Swamper Who Falsely Accused Michael Flynn of Russian Collusion as National Security Advisor	BP	
t3_k12qyb	Alyssa Milano extends 'olive branch to Trump supporters' — and the left-wing, Trump-despising actress gets totally torched	O	
t3_k0lrz6	Trump reportedly set to pardon Michael Flynn	TP	
t3_k0ylof	Biden Team Hopes to Reverse Trump’s Policies and Return America to Endless Wars, Stagnation and Despair [Satire](but not really)	BP	
t3_k12pqx	BREAKING: Michael Flynn granted full pardon by President Donald Trump	TP	
t3_k12zj1	Trump Legal Team Scored a Big Win in Nevada. Could It Lead to a 2020 Bombshell?	EF	
t3_k118bv	President Trump pardons Michael Flynn	TP	
t3_k0u2y7	After President Trump Gets Setback In Pennsylvania – The 3rd Circuit Court Just Granted Donald An Expedited Review	EF	
t3_k0ybnn	Biden Will Propose 'Path to Citizenship' For 11 Million Illegals First 100 Days in Office, Likely Trigger New Border Crisis	BP	
t3_k1129d	Trump pardons his former National Security Adviser Michael Flynn	TP	
t3_k0qpwq	Nearly a Tenth of Biden Voters in Key States Would Not Have Voted for Him Had They Known About Hunter Biden Scandal	BS	
t3_k11afj	Trump pardons ex-National Security Adviser Flynn	TP	
t3_k14i15	"Mysterious” Election Day Spike Gave Biden Nearly 600,000 Votes, Only 3,200 for Trump	EF	
t3_k12ycx	After Years Of Russia Hoax Persecutions, Trump Pardons Michael Flynn	TP	
t3_k12y22	Tom Cotton: Biden DHS Nominee Mayorkas Disqualified to Lead Agency for Selling Green Cards to Chinese Nationals	BS	
t3_k0uub6	Is there any doubt that Trump was right to fire James Comey?.	TS	
t3_k0r69g	Biden: Amnesty for 'Over 11M' Illegals Going to Senate in First 100 Days	BP	
t3_k0ppz7	Biden’s New Secretary Of State Could Be In Trouble – Emails Show Hunter Biden Requested Meeting With Blinken	BS	
t3_k0ugpb	Hillary Clinton among names being considered for Biden Secretary of defense.	BP	
t3_k1049j	Alyssa Milano’s Attempt To Make Peace With Trump Supporters Backfires	O	
t3_k13unn	Trump pardons former national security advisor Michael Flynn	TP	
t3_k12rjd	Joe Biden Recites Alphabet To Prove His Mental State ‘strong’	BS	
t3_k12jio	Afghan Vet Johnny Jones On Biden’s Gun Control Plan: That’ll Trigger 2022 GOP Landslide	BP	
t3_k0u4x0	President Obama Shares His Disappointment in Evangelical Hispanics Who Voted for Trump	O	
t3_k0k7wi	US should encourage China's rise, Biden national security pick Jake Sullivan says	BP	
t3_k0zxou	Barack Obama: Pro-Trump Latinos Cling to Religion	O	
t3_k0rs78	US election 2020: Biden says White House co-operation 'sincere'	T	
t3_k0wx36	Biden National Security Adviser Pick Said "Al-Qaeda Is On Our Side" in Syria	BS	
t3_k0t2ng	Biden's Homeland Security pick flagged by whistleblowers for preferential treatment with visas	BS	
t3_k12gc8	Trump pardons former national security adviser Michael Flynn	TP	
t3_k0vsw1	Trump Lawyers Want Rudy Giuliani to Argue in Federal Court Again: Document	TP	
t3_k0v1z1	Poll: Just 3% of Trump voters believe Biden won fairly, 73% think Trump is the legitimate winner	EF	
t3_k0j56p	FAKE NEWS: ABC, NBC Suck Up to ‘Diverse’ Biden Picks as ‘Mainstream,’ ‘Not Political’	BS	
t3_k14p7g	Trump: 2020 'Long Way From Over'	O	
t3_k11b64	Biden's Policy Proposals Would Harm Economy	BP	
t3_k0ypop	The Return of Obama–Biden Energy Cronyism. Green lobbyists and other Obama favorites are about to enter a new golden age.	BP	
t3_k0wvyv	Scarborough on Operation Warp Speed: Trump's Legacy on 'Could Be Considered an Unqualified Success'	TS	
t3_k0voli	Media fawns over Biden's Cabinet rollout, describes 'being rescued from this craziness' by 'superheroes'	BP	
t3_k0jwo5	Clyburn: 'I Wish' Bernie Sanders Would Join Biden Administration	O	
t3_k14v0m	Obama Attacks Trump for Using Same 'Cages' at Border He Used	TS	
t3_k14cn1	Huge court win lets Trump present ballot evidence, could overturn Nevada result	EF	
t3_k0k0z2	US should encourage China's rise, Biden national security pick Jake Sullivan says	BP	
t3_k0rt9t	Georgia secretary of state: My family voted for Trump. He threw us under the bus anyway.	O	
t3_k1466q	Joe Biden urges nation to ‘forgo family traditions’ on Thanksgiving	BP	
t3_k10l0l	Alyssa Milano extends 'olive branch' to Trump supporters after months of scathing rebukes	O	
t3_k14od3	Rep. Reschenthale: 'Premature' for Pennsylvania to Certify Election Results for Biden	ER	
t3_k0svmv	Media Censoring Negative Biden News May Have Cost Trump The Election Swing State Poll Shows	EF	
t3_k0kty5	Generation Forever War: Biden’s National Security Picks Herald Return to Hawkish Normalcy	BP	
t3_k124l8	The Revenge of The Swamp! Biden Lefty Transition, Big Tech Censorship, Truth &amp; Reconciliation!?(The Happy Warrior Podcast)	O	
t3_k17bp7	Tokyo residents back President Trump, say if Biden wins China wins	O	
t3_k16wte	Trump Calls on Supporters to Stand Tall: 'Don't Be Intimidated by These People'	O	
t3_k1e0sd	Joe Biden is slammed for saying he will immediately push a bill for pathway to citizenship for 11 million undocumented people in America 'rather than concentrate on COVID'	BS	
t3_k1hr9e	Trump Lawyer Jenna Ellis Receives Threats: 'You Deserved to Be Raped'	O	
t3_k17zpq	Trump Announces He Will Only Leave Office If A Challenger Beats Him In Ritual Combat	EF	
t3_k1gjra	If Voters Had Known About 8 Stories Media Ignored, Trump Would Have Won, Says Media Watchdog	EF	
t3_k1jxva	Newsmax/McLaughlin Poll: Two-Thirds of Nation Backs Trump on Recounts	EF	
t3_k1l71u	Thanksgiving Proclamation: Donald Trump Celebrates 400th Anniversary of Plymouth Rock Landing	O	
t3_k1eya6	Biden UN, State Dept Picks Are Documented Chinese Communist Party Consultants	BS	
t3_k1fuat	Overstock founder says he has proof election was rigged for Biden	EF	
t3_k1fx19	Biden’s Pick for National Security Adviser Sent Classified Emails on Clinton’s Server, Hyped Fake Trump-Russia Collusion Story	BS	
t3_k18cqo	Trump Exhorts Supporters: Don't Be Intimidated by Dems, Others	O	
t3_k1b0te	Huge court win lets Trump present ballot evidence, could overturn Nevada result	EF	
t3_k1isqi	Computer Repairman Who Found Hunter Biden's Laptop Has Vanished, Reports Cite 'Death Threats'	BS	
t3_k1ahcn	Summary of the kraken: Sidney Powell sues Georgia officials, alleging massive scheme to rig election for Joe Biden	EF	
t3_k175f3	Huge court win lets Trump present ballot evidence, could overturn Nevada result	EF	
t3_k1q4qj	Trump Says He'll Leave Office if Electoral College Votes for Biden	T	
t3_k1qtwn	Biden breaks Obama’s record for lowest number of counties won	ER	
t3_k1g0n7	Hey look! It’s more of those dead voters that “don’t exist”. This time it’s taken up in court and doesn’t have to deal with Trump, so it might be given fair coverage.	EF	
t3_k16pbr	Biden urges Americans to 'forgo family traditions' on Thanksgiving to fight COVID-19	BP	
t3_k1enjh	Biden Taps Staffer Who Said Suicide Bombings Were 'Last Resort' for Palestinians	BS	
t3_k1c3b7	Poll: 90% of Harvard Freshmen Support Joe Biden	ER	
t3_k18mt0	LATEST: Trump Pardons Michael Flynn, Who Endured Years of Apparent Prosecutorial Misconduct by FBI	TP	
t3_k1gfbw	March for Trump' bus tour to demand 'election integrity' -- The "March for Trump", organized by Women for America First, will launch in Palm Beach then wind its way through 16 states, concluding Dec. 12 in Washington, D.C.	EF	
t3_k18krk	Trump Calls Into the PA State Senate Hearing as Senators Hear Stunning Accounts of Election Irregularities	EF	
t3_k1pe3o	Mattis didn't disclose ties to China-boosting firm in column slamming Trump's 'America First' policy	TP	
t3_k18f4u	Rand Paul Says He Will Ask Biden’s Secretary Of State Pick Tony Blinken To Apologize For Supporting War In Iraq	BS	
t3_k18b3h	Biden: Americans 'Won't Stand' for Election Results Not Being Honored	EF	
t3_k19ptk	Trump-allied legal activist: GOP vote suppression reminiscent of Jim Crow-era ballot bias	EF	
t3_k1o2ht	AOC insists Biden can use executive order to cancel student loan debt	BP	
t3_k1phbw	Justin Webb: Biden’s battle with his leftist party is just beginning	BS	
t3_k1693z	‘Absolutely No Allegations of Any Fraud’: Pa. Court Rejects Trump Campaign’s Appeal Over 69 Mail-In Ballots	EF	
t3_k1r7ok	Latest Poll: Two-Thirds of Nation Back Trump on Recounts	EF	
t3_k1r7g8	Trump Encourages Americans to Offer Thanks to God, Get Together With Family for Thanksgiving	TP	
t3_k1c2wm	Chinese Media Bark Orders at Biden	O	
t3_k1fawe	Implications of the Flynn Pardon -- President Trump’s pardon not only ends any injustice to Flynn, but it restores the proper balance to the separation of powers.	TP	
t3_k1liko	FLASHBACK: John McCain Called Biden Secretary of State Pick Tony Blinken "Unqualified"	BP	
t3_k18t9c	FakeNYTimes: Donald Trump Refuses to Concede 2024 Election	O	
t3_k1l71w	Devout Catholic, Joe Biden, doesn't know that when pronouncing probably the most famous book in the bible, the P is silent in Psalms.	BS	
t3_k1qpth	Biden’s National Security Adviser Wants To ‘Encourage China’s Rise’	BP	
t3_k1r61l	Joe Biden Tries to Quote Book in the Bible, It Goes Horribly Wrong -- "Devout Catholic" Joe Biden doesn't know the "P" in "Psalmist" is silent, not the "s".	BS	
t3_k1r3jc	Infographic: The 4-Year-Long Campaign Against Trump	O	
t3_k1q3jw	Ken Timmerman: Revenge of the Swamp Creatures (Biden's Cabinet)	BS	
t3_k1esn1	Clemency Seekers Likely to Descend Upon Trump White House. Dershowitz says the president "was very interested in the concept of the pardon power being more than just clemency, but being part of the system of checks and balances for excessive legislative or judicial actions."​	TP	
t3_k1hu8z	Joe Scarborough: Won't Go Back to GOP After It Backed Trump	TS	
t3_k1okst	Joe Biden’s Moderate Mask Slips Off – He Just Admitted He’s Planning To Execute A “Very Progressive Agenda”	BS	
t3_k1deyj	Barack Obama: Pro-Trump ‘Evangelical Hispanics’ Care More About Abortion than ‘Cages'	O	
t3_k1gm65	China threatens economic pain for UK over Huawei crackdown as Trump exit looms	T	
t3_k1c44i	Report: Israel's Army Preparing in Case Trump Strikes Iran	TP	
t3_k1pdp5	How (the Great President) Trump’s vaccine effort produced results at ‘warp speed’	TP	
t3_k1g6mh	Trump does the right thing by pardoning Gen. Flynn | Spectator USA	TP	
t3_k1fb6q	Will Obama Torture Apologists Make a Triumphant Return to Joe Biden's White House?	BP	
t3_k16q8a	Former Acting ICE Director Tom Homan warns of 'outta control' border under a Biden administration	BP	